.       sil
,       sil
?       sil
!       sil
ABAD	A B A D 
ABAIKAN	A B AY K A N 
ABDUL	A B D U L 
ABDULLAH	A B D U L L A H 
ABDURRAHMAN	A B D U R R A H M A N 
ABERSON	A B E R S O N 
ABG	A B E G E 
ABIDIN	A B I D I N 
ABILIO	A B I L I O 
ABIMANYU	A B I M A NY U 
ABNORMALITAS	A B N O R M A L I T A S 
ABOLISI	A B O L I S I 
ABSTAIN	A B S T EY N 
ABSURD	A B S U R D 
ACAK	A C A K 
ACARA	A C A R A 
ACEH	A C E H 
ACHJAR	A KH Y A R 
ACHMAD	A KH M A D 
ACHWAN	A KH W A N 
ACUAN	A C U A N 
ADA	A D A 
ADAKAH	A D A K A H 
ADALAH	A D A L A H 
ADANYA	A D A NY A 
ADE	A D E 
AD-HOC	E D H O K 
ADIK	A D I K 
ADIS	A D I S 
ADITYASWARA	A D I T Y A S W A R A 
ADJI	A J I 
ADMINISTRASI	A D M I N I S T R A S I 
ADRIANUS	A D R I A N U S 
ADU	A D U 
ADUHAI	A D U H AY 
ADVIS	A D F I S 
ADZAN	A D Z A N 
AFDAL	A F D A L 
AFFAN	A F A N 
AFGANI	A F G A N I 
AFGANISTAN	A F G A N I S T A N 
AFTA	A F T A 
AGAK	A G A K 
AGAMA	A G A M A 
AGAMANYA	A G A M A NY A 
AGAR	A G A R 
AGENDA	A G E N D A 
AGFAR	A G F A R 
AGUNG	A G U NG 
AGUS	A G U S 
AGUSTUS	A G U S T U S 
AGWUNOBI	A G W U N O B I 
AHLI	A H L I 
AHMAD	A H M A D 
AIR	A I R 
AIRLANGGA	EY R L A NG G A 
AIRNYA	A I R NY A 
AJAK	A J A K 
AJANG	A J A NG 
AJARAN	A J A R A N 
AJI	A J I 
AJINOMOTO	A J I N O M O T O 
AJUN	A J U N 
AKAL	A K A L 
AKAN	A K A N 
AKANKAH	A K A N K A H 
AKAR	A K A R 
AKBAR	A K B A R 
AKHIR	A KH I R 
AKHIR-AKHIR	A KH I R A KH I R 
AKHIRNYA	A KH I R NY A 
AKIBAT	A K I B A T 
AKIBATNYA	A K I B A T NY A 
AKRAB	A K R A B 
AKSI	A K S I 
AKU	A K U 
ALA	A L A 
ALAM	A L A M 
ALAMAT	A L A M A T 
ALANGKAH	A L A NG K A H 
ALASAN	A L A S A N 
ALASANNYA	A L A S A N NY A 
ALAT	A L A T 
ALAUDDIN	A L A U D I N 
ALBAR	A L B A R 
ALBUM	A L B U M 
ALDOURI	A L D O U R I 
ALERGEN	A L E R G E N 
ALERGI	A L E R G I 
ALEX	A L E K S 
ALFARIDZI	A L F A R I D Z I 
AL-GHOZI	A L G O Z I 
ALGOJO	A L G O J O 
ALI	A L I 
ALIAS	A L I A S 
ALIH	A L I H 
ALIRAN	A L I R A N 
AL-JOHAR	A L J O H A R 
ALKOTSAR	A L K O T S A R 
ALMARHUM	A L M A R H U M 
ALTERNATIF	A L T E2 R N A T I F 
ALUMINIUM	A L U M I N I U M 
ALVIN	A L F I N 
ALWI	A L W I 
AMAL	A M A L 
AMAN	A M A N 
AMANDEMEN	A M A N D E2 M E N 
AMARAH	A M A R A H 
AMAR	A M A R 
AMAZON	A M A Z O N 
AMBIL	A M B I L 
AMBILKAN	A M B I L K A N 
AMBIVALENSI	A M B I F A L E N S I 
AMBLESNYA	A M B L E2 S NY A 
AMBOINA	A M B OY N A 
AMBON	A M B O N 
AMBURADUL	A M B U R A D U L 
AMERIKA	A M E R I K A 
AMIEN	A M I N 
AMIR	A M I R 
AMIRUDDIN	A M I R U D I N 
AMNESTI	A M N E S T I 
AMPAS	A M P A S 
AMPLOP	A M P L O P 
AMRIN	A M R I N 
AMROZI	A M R O Z I 
ANAK	A N A K 
ANAK-ANAK	A N A K A N A K 
ANAKNYA	A N A K NY A 
ANALIS	A N A L I S 
ANALISIS	A N A L I S I S 
ANAM	A N A M 
ANCAMAN	A NY C A M A N 
ANCAM	A NY C A M 
ANDA	A N D A 
ANDALAN	A N D A L A N 
ANDERSON	E N D E2 R S E2 N 
ANDREAN	A N D R E A N 
ANEH	A N E H 
ANEKDOT	A N E K D O T 
ANGGAP	A NG G A P 
ANGGARAN	A NG G A R A N 
ANGGITO	A NG G I T O 
ANGGOTA	A NG G O T A 
ANGGREK	A NG G R E K 
ANGGUR	A NG G U R 
ANGIN	A NG I N 
ANGKA	A NG K A 
ANGKATAN	A NG K A T A N 
ANGKAT	A NG K A T 
ANGKOT	A NG K O T 
ANGKUTAN	A NG K U T A N 
ANGKUT	A NG K U T 
ANJLOK	A NY J L O K 
ANJURKAN	A NY J U R K A N 
ANNAN	A N A N 
ANSYORI	A N SY O R I 
ANTAM	A N T A M 
ANTARA	A N T A R A 
ANTAR	A N T A R 
ANTARANYA	A N T A R A NY A 
ANTARNEGARA	A N T A R N E2 G A R A 
ANTI-ABDURRAHMAN	A N T I A B D U R R A H M A N 
ANTI	A N T I 
ANTING	A N T I NG 
ANTITEROR	A N T I T E R O R 
ANTRIAN	A N T R I A N 
ANWAR	A N W A R 
APA	A P A 
APA-APA	A P A A P A 
APABILA	A P A B I L A 
APAKAH	A P A K A H 
APALAGI	A P A L A G I 
APAPUN	A P A P U N 
APARAT	A P A R A T 
APARTEMEN	A P A R T E2 M E N 
APBN	A P E B E K E N 
APEL	A P E L 
APES	A P E2 S 
API	A P I 
AQSO	A K S O 
AQUINO	A K U I N O 
ARAFAT	A R A F A T 
ARAFAT-POWELL	A R A F A T P O W E2 L 
ARAH	A R A H 
ARANSEMEN	A R A N S E2 M E N 
ARANSEMENNYA	A R A N S E2 M E N NY A 
ARAUJO	A R A U J O 
AREFA	A R E F A 
ARGO	A R G O 
ARIF	A R I F 
ARIFIN	A R I F I N 
ARIO	A R I O 
ARLOJI	A R L O J I 
AROGAN	A R O G A N 
ARROYO	A R O Y O 
ARSIP	A R S I P 
ARSYAD	A R SY A D 
ARTI	A R T I 
ARTIJO	A R T I J O 
ARTINYA	A R T I NY A 
ARTISTIK	A R T I S T I K 
ARUN	A R U N 
ARUS	A R U S 
ARY	A R I 
ASAL	A S A L 
ASAL-ASALAN	A S A L A S A L A N 
ASALKAN	A S A L K A N 
ASAM	A S A M 
AS	A S 
ASBAK	A S B A K 
ASEAN	A S E A N 
ASEP	A S E P 
ASET	A S E T 
ASIA	A S I A 
ASING	A S I NG 
ASINGNYA	A S I NG NY A 
ASLI	A S L I 
ASOSIASI	A S O S I A S I 
ASPAL	A S P A L 
ASPEK	A S P E K 
ASPIRASI	A S P I R A S I 
ASRAMA	A S R A M A 
ASRAMAGATE	A S R A M A G EY T 
ASSEGAF	A S E G A F 
ASTIKA	A S T I K A 
ASTRA	A S T R A 
ASUMSI	A S U M S I 
ASWJ	A K E S W E J E 
ASYARI	A SY A R I 
ASYIK	A SY I K 
ATAP	A T A P 
ATASAN	A T A S A N 
ATAS	A T A S 
ATASNYA	A T A S NY A 
ATAU	A T AW 
ATAUPUN	A T AW P U N 
ATEF	A T E F 
ATLET	A T L E T 
ATM	EY T I E M 
ATMODJO	A D M O J O 
ATMOSFER	A T M O S F E R 
ATRAKSI	A T R A K S I 
ATRIBUT	A T R I B U T 
AUDIT	A U D I T 
AUSTRALIA	A U S T R A L I A 
AWAL	A W A L 
AWALLUDIN	A W A L U D I N 
AWALNYA	A W A L NY A 
AWAM	A W A M 
AYAH	A Y A H 
AYAM	A Y A M 
AYIP	A Y I P 
AYO	A Y O 
AZAS	A Z A S 
AZERBAIJAN	A Z E R B A I J A N 
AZIS	A Z I S 
AZIZ	A Z I S 
AZIZY	A Z I Z I 
AZMI	A Z M I 
AZNANI	A Z N A N I 
AZRA	A Z R A 
AZTARMIZI	A Z T A R M I Z I 
AZWAR	A Z W A R 
AZYUMARDI	A Z Y U M A R D I 
AZZAHRA	A Z Z A H R A 
AZZURI	A Z Z U R I 
BAASYIR	B A K A SY I R 
BABAK	B A B A K 
BACHRUMSYAH	B A KH R U M SY A H 
BACHTIAR	B A KH T I A R 
BADAI	B A D AY 
BADAN	B A D A N 
BAGAI	B A G AY 
BAGAIKAN	B A G AY K A N 
BAGAIMANA	B A G AY M A N A 
BAGASI	B A G A S I 
BAGIAN	B A G I A N 
BAGI	B A G I 
BAGIMU	B A G I M U 
BAGJA	B A G J A 
BAGUS	B A G U S 
BAH	B A H 
BAHKAN	B A H K A N 
BAHUNYA	B A H U NY A 
BAHWA	B A H W A 
BAIK	B A I K 
BAIK-BAIK	B A I K B A I K 
BAIKLAH	B A I K L A H 
BAJA	B A J A 
BAJAJ	B A J AY 
BAJU	B A J U 
BAKAL	B A K A L 
BAK	B A K 
BAKU	B A K U 
BALDAN	B A L D A N 
BALE	B A L E 
BALFAS	B A L F A S 
BALI	B A L I 
BALIBO	B A L I B O 
BALKON	B A L K O N 
BAMBANG	B A M B A NG 
BANDA	B A N D A 
BANDARA	B A N D A R A 
BANDENG	B A N D E2 NG 
BANDUNG	B A N D U NG 
BANGAU	B A NG AW 
BANG	B A NG 
BANGKAI	B A NG K AY 
BANGSA	B A NG S A 
BANGSA-BANGSA	B A NG S A B A NG S A 
BANGUNAN	B A NG U N A N 
BANGUN	B A NG U N 
BANJIR	B A NY J I R 
BANK	B A NG 
BANKIR	B A NG K I R 
BANTAH	B A N T A H 
BANTARAN	B A N T A R A N 
BANTEN	B A N T E2 N 
BANTUAN	B A N T U A N 
BANTU	B A N T U 
BANYAK	B A NY A K 
BANYAKNYA	B A NY A K NY A 
BANYUURIP	B A NY U U R I P 
BANYUWANGI	B A NY U W A NG I 
BAPAK	B A P A K 
BAPAKKU	B A P A K K U 
BAPEPAM	B A P E2 P A M 
BARANG	B A R A NG 
BARANG-BARANG	B A R A NG B A R A NG 
BARAT	B A R A T 
BAR	B A R 
BARO	B A R O 
BARU	B A R U 
BASAH	B A S A H 
BASRI	B A S R I 
BASYUNI	B A SY U N I 
BATAK	B A T A K 
BATAL	B A T A L 
BATAM	B A T A M 
BATANG	B A T A NG 
BATUBARA	B A T U B A R A 
BATU	B A T U 
BAU	B A U 
BAUNYA	B A U NY A 
BAWAAN	B A W A K A N 
BAWAH	B A W A H 
BAWAKAN	B A W A K A N 
BAWAZIER	B A W A Z I R 
BAYANGKAN	B A Y A NG K A N 
BAYAR	B A Y A R 
BAYI	B A Y I 
BAYI-BAYI	B A Y I B A Y I 
BAYINYA	B A Y I NY A 
BAYU	B A Y U 
BEA	B E A 
BEBAN	B E2 B A N 
BEBAS	B E B A S 
BEBERAPA	B E2 B E2 R A P A 
BECKHAM	B E KH A M 
BECUS	B E2 C U S 
BEDANYA	B E D A NY A 
BEDDU	B E2 D U 
BEGITU	B E2 G I T U 
BEIJING	B E I J I NG 
BEJ	B E K E J E 
BEJO	B E2 J O 
BEKER	B E K E2 R 
BEKERJA	B E2 K E2 R J A 
BELA	B E L A 
BELAJAR	B E2 L A J A R 
BELAKANGAN	B E2 L A K A NG A N 
BELAKANG	B E2 L A K A NG 
BELAKANGNYA	B E2 L A K A NG NY A 
BELANDA	B E2 L A N D A 
BELANJA	B E2 L A NY J A 
BELAS	B E2 L A S 
BEL	B E L 
BELGIA	B E L G I A 
BELIAU	B E2 L I A U 
BELI	B E2 L I 
BELO	B E L O 
BELUM	B E2 L U M 
BENAR	B E2 N A R 
BENAR-BENAR	B E2 N A R B E2 N A R 
BENCANA	B E2 NY C A N A 
BENDA	B E2 N D A 
BENDERA	B E2 N D E R A 
BENER	B E N E2 R 
BENGKEL	B E NG K E L 
BENGKULU	B E2 NG K U L U 
BENTENG	B E N T E NG 
BENTROKAN	B E2 N T R O K A N 
BENTUK	B E2 N T U K 
BENYAMIN	B E NY A M I N 
BEPERGIAN	B E2 P E2 R G I A N 
BERADA	B E2 R A D A 
BERAKHIR	B E2 R A KH I R 
BERAMBUT	B E2 R A M B U T 
BERANDAI-ANDAI	B E2 R A N D AY A N D AY 
BERANEKA	B E2 R A N E K A 
BERANGKAT	B E2 R A NG K A T 
BERANI	B E2 R A N I 
BERANTAI	B E2 R A N T AY 
BERANTAKAN	B E2 R A N T A K A N 
BERAPA	B E2 R A P A 
BERARTI	B E2 R A R T I 
BERAS	B E2 R A S 
BERAT	B E2 R A T 
BERBAGAI	B E2 R B A G AY 
BERBAHASA	B E2 R B A H A S A 
BERBAHAYA	B E2 R B A H A Y A 
BERBANDING	B E2 R B A N D I NG 
BERBATASAN	B E2 R B A T A S A N 
BERBAU	B E2 R B A U 
BERBEDA	B E2 R B E D A 
BERBEDA-BEDA	B E2 R B E D A B E D A 
BERBENTUK	B E2 R B E2 N T U K 
BERBESAR	B E2 R B E2 S A R 
BERBICARA	B E2 R B I C A R A 
BERCAMPUR	B E2 R C A M P U R 
BERDARAH	B E2 R D A R A H 
BERDASARKAN	B E2 R D A S A R K A N 
BERDEKATAN	B E2 R D E2 K A T A N 
BERDEMOKRASI	B E2 R D E M O K R A S I 
BERDETAK	B E2 R D E2 T A K 
BERDINDING	B E2 R D I N D I NG 
BERDIRI	B E2 R D I R I 
BERDOA	B E2 R D O K A 
BEREBUT	B E2 R E2 B U T 
BERENANG	B E2 R E2 N A NG 
BERENCANA	B E2 R E2 NY C A N A 
BERES	B E R E S 
BERGANTIAN	B E2 R G A N T I A N 
BERGARANSI	B E2 R G A R A N S I 
BERGEGASLAH	B E2 R G E2 G A S L A H 
BERGOYANG	B E2 R G O Y A NG 
BERGUNA	B E2 R G U N A 
BERGUNJING	B E2 R G U NY J I NG 
BERHASIL	B E2 R H A S I L 
BERHENTI	B E2 R H E2 N T I 
BERI	B E2 R I 
BERIKAN	B E2 R I K A N 
BERIKUT	B E2 R I K U T 
BERIMAN	B E2 R I M A N 
BERIRAMA	B E2 R I R A M A 
BERISI	B E2 R I S I 
BERITA	B E2 R I T A 
BERITAHU	B E2 R I T A U 
BERJALAN	B E2 R J A L A N 
BERJANJI	B E2 R J A NY J I 
BERJATUHAN	B E2 R J A T U H A N 
BERJIHAD	B E2 R J I H A D 
BERJUDUL	B E2 R J U D U L 
BERKAITAN	B E2 R K A I T A N 
BERKALI-KALI	B E2 R K A L I K A L I 
BERKAMPANYE	B E2 R K A M P A NY E2 
BERKEDIP-KEDIP	B E2 R K E2 D I P K E2 D I P 
BERKEMBANGNYA	B E2 R K E2 M B A NG NY A 
BERKHIANAT	B E2 R KH I A N A T 
BERKONSENTRASI	B E2 R K O N S E N T R A S I 
BERKONSENTRASILAH	B E2 R K O N S E N T R A S I L A H 
BERKORELASI	B E2 R K O R E L A S I 
BERKUASA	B E2 R K U A S A 
BERKULIT	B E2 R K U L I T 
BERKUMPUL	B E2 R K U M P U L 
BERKUNJUNG	B E2 R K U NY J U NG 
BERKURANG	B E2 R K U R A NG 
BERLAGA	B E2 R L A G A 
BERLALU	B E2 R L A L U 
BERLANGSUNG	B E2 R L A NG S U NG 
BERLANTAI	B E2 R L A N T AY 
BERLARUT-LARUTNYA	B E2 R L A R U T L A R U T NY A 
BERLEBIHAN	B E2 R L E2 B I H A N 
BERLENDIR	B E2 R L E2 N D I R 
BERLOGO	B E2 R L O G O 
BERLOMBA	B E2 R L O M B A 
BERLOTENG	B E2 R L O T E NG 
BERMAIN	B E2 R M A I N 
BERMASALAH	B E2 R M A S A L A H 
BERMOTIF	B E2 R M O T I F 
BERMOTOR	B E2 R M O T O R 
BERMUKIM	B E2 R M U K I M 
BERNOMOR	B E2 R N O M O R 
BERPENDAPAT	B E2 R P E2 N D A P A T 
BERSALAH	B E2 R S A L A H 
BERSAMA	B E2 R S A M A 
BERSAMAMU	B E2 R S A M A M U 
BERSEDIA	B E2 R S E2 D I A 
BERSEPEDA	B E2 R S E2 P E D A 
BERSIAGA	B E2 R S I A G A 
BERSIFAT	B E2 R S I F A T 
BERSIH	B E2 R S I H 
BERSIHKAN	B E2 R S I H K A N 
BERSIKAP	B E2 R S I K A P 
BERSIMBAH	B E2 R S I M B A H 
BERSINGGUNGAN	B E2 R S I NG G U NG A N 
BERSPEKULASI	B E2 R S P E K U L A S I 
BERSPREI	B E2 R S P R EY 
BERSUJUD	B E2 R S U J U D 
BERSYUKUR	B E2 R SY U K U R 
BERTAHAN	B E2 R T A H A N 
BERTANDING	B E2 R T A N D I NG 
BERTANGGUNG	B E2 R T A NG G U NG 
BERTELE-TELE	B E2 R T E L E T E L E 
BERTEMU	B E2 R T E2 M U 
BERTEMUNYA	B E2 R T E2 M U NY A 
BERTERBANGAN	B E2 R T E2 R B A NG A N 
BERTERIMA	B E2 R T E2 R I M A 
BERTIKAI	B E2 R T I K AY 
BERTINDAK	B E2 R T I N D A K 
BERTOLAK	B E2 R T O L A K 
BERTRANSFORMASI	B E2 R T R A N S F O R M A S I 
BERTUKAR	B E2 R T U K A R 
BERUBAH	B E2 R U B A H 
BERUNDING	B E2 R U N D I NG 
BERUNJUK	B E2 R U NY J U K 
BERUPA	B E2 R U P A 
BERUSAHA	B E2 R U S A H A 
BERWARNA	B E2 R W A R N A 
BERWENANG	B E2 R W E2 N A NG 
BERWUJUD	B E2 R W U J U D 
BERYODIUM	B E2 R Y O D I U M 
BERZIARAH	B E2 R Z I A R A H 
BESAR	B E2 S A R 
BESARNYA	B E2 S A R NY A 
BESERTA	B E2 S E2 R T A 
BESOK	B E S O K 
BESUKI	B E2 S U K I 
BETAWI	B E2 T A W I 
BETUL	B E2 T U L 
BETUL-BETUL	B E2 T U L B E2 T U L 
BIAR	B I A R 
BIARKAN	B I A R K A N 
BIASA	B I A S A 
BIASANYA	B I A S A NY A 
BIAYA	B I A Y A 
BIAYANYA	B I A Y A NY A 
BIBIT	B I B I T 
BICARA	B I C A R A 
BICARANYA	B I C A R A NY A 
BIDANG	B I D A NG 
BILA	B I L A 
BILYET	B I L Y E T 
BIMANTORO	B I M A N T O R O 
BINA	B I N A 
BINGUNG	B I NG U NG 
BINJAI	B I NY J AY 
BINTANG	B I N T A NG 
BIOGRAFI	B I O G R A F I 
BIOHANIS	B I O H A N I S 
BIOLOGI	B I O L O G I 
BIOTEKNOLOGI	B I O T E K N O L O G I 
BIR	B I R 
BIRO	B I R O 
BIROKRASI	B I R O K R A S I 
BIRU	B I R U 
BISA	B I S A 
BISAKAH	B I S A K A H 
BISNIS	B I S N I S 
BISRI	B I S R I 
BLAK-BLAKAN	B L A K B L A K A N 
BLANKO	B L A NG K O 
BLITAR	B L I T A R 
BLOKADE	B L O K A D E2 
BLOK-M	B L O K M 
BLUE	B L U 
BLUS	B L U S 
BOALEMO	B O A L E M O 
BOB	B O B 
BOCOR	B O C O R 
BODOH	B O D O H 
BOGEM	B O G E2 M 
BOGOR	B O G O R 
BOHLAM	B O H L A M 
BOIKOT	B OY K O T 
BOJONEGORO	B O J O N E2 G O R O 
BOLAK-BALIK	B O L A K B A L I K 
BOLEH	B O L E H 
BOLEHKAH	B O L E H K A H 
BOM	B O M 
BONDED-ZONE	B O N D E2 D Z O N 
BONDOWOSO	B O N D O W O S O 
BORGOL	B O R G O L 
BORNEO	B O R N E O 
BOROBUDUR	B O R O B U D U R 
BOSNIA	B O S N I A 
BOSTON	B O S T O N 
BOTOL	B O T O L 
BOWO	B O W O 
BOYOLALI	B O Y O L A L I 
BPPT	B E P E P E T E 
BRAILE	B R A I L E2 
BRANKAS	B R A NG K A S 
BRAZIL	B R A Z I L 
BREWOK	B R E W O K 
BRIGJEN	B R I G J E N 
BRIMOB	B R I M O B 
BROKER	B R O K E2 R 
BROMO	B R O M O 
BRUNAIGATE	B R U N AY G EY T 
BRUNEI	B R U N EY 
BRUNEIGATE	B R U N EY G EY T 
BRUSSELS	B R U S E2 L S 
BUAH	B U A H 
BUATAN	B U A T A N 
BUAT	B U A T 
BU	B U 
BUCHORI	B U KH O R I 
BUDAYA	B U D A Y A 
BUDHA	B U D A 
BUDIANTO	B U D I A N T O 
BUDIARTO	B U D I A R T O 
BUDI	B U D I 
BUJETER	B A J E2 T E R 
BUKA	B U K A 
BUKAN	B U K A N 
BUKANKAH	B U K A N K A H 
BUKANLAH	B U K A N L A H 
BUKTI	B U K T I 
BUKU	B U K U 
BUKUNYA	B U K U NY A 
BULAN	B U L A N 
BULAN-BULAN	B U L A N B U L A N 
BULDOZER	B U L D O Z E2 R 
BULOGATE	B U L O G EY T 
BULOG	B U L O G 
BULOGGATE	B U L O G G EY T 
BUMBU-BUMBU	B U M B U B U M B U 
BUMI	B U M I 
BUMN	B E K U K E M E N 
BUNDAR	B U N D A R 
BUNGA	B U NG A 
BUNGA-BUNGA	B U NG A B U NG A 
BUNG	B U NG 
BUNGO	B U NG O 
BUNTAL	B U N T A L 
BUNTET	B U N T E2 T 
BUPATI	B U P A T I 
BURHANUDDIN	B U R H A N U D I N 
BURON	B U R O N 
BURSA	B U R S A 
BURUH	B U R U H 
BURUK	B U R U K 
BURUNG	B U R U NG 
BUS	B U S 
BUSUK	B U S U K 
BUTIR	B U T I R 
BUTUHKAN	B U T U H K A N 
BUYAT	B U Y A T 
CABANG	C A B A NG 
CABUT	C A B U T 
CACAT	C A C A T  
CADILLAC	K A D I L A K 
CAHYO	C A H Y O 
CAIRAN	C A I R A N 
CAIR	C A I R 
CAKUPAN	C A K U P A N 
CALL	K AW L 
CALO	C A L O 
CALON	C A L O N 
CAMAT	C A M A T 
CAMPURAN	C A M P U R A N 
CAMPUR	C A M P U R 
CANANG	C A N A NG 
CANTIK	C A N T I K 
CAP	C A P 
CARA	C A R A 
CARANYA	C A R A NY A 
CARSTEN	K A R S T E N 
CATATAN	C A T A T A N 
CAT	C A T 
CAWANG-TOMANG-PLUIT	C A W A NG T O M A NG P L U I T 
CDMA	C E D E K E M A 
CEBURKAN	C E2 B U R K A N 
CECEP	C E C E P 
CECERAN	C E C E R A N 
CEDERA	C E2 D E2 R A 
CEKATAN	C E2 K A T A N 
CEK	C E K 
CEKCOK	C E K C O K 
CELANA	C E2 L A N A 
CEMERLANG	C E2 M E2 R L A NG 
CENCEN	C E NY C E N 
CENDEKIAWAN	C E2 N D E2 K I A W A N 
CENDERAWASIH	C E N D E2 R A W A S I H 
CENDERUNG	C E2 N D E2 R U NG 
CENGENG	C E NG E NG 
CENGKEH	C E2 NG K E H 
CENGKEHNYA	C E2 NG K E H NY A  
CENTER	S E N T E2 R 
CEPAT	C E2 P A T 
CERAH	C E2 R A H 
CERDAS	C E2 R D A S 
CERIA	C E2 R I A 
CERITA	C E2 R I T A 
CERITAKAN	C E2 R I T A K A N 
CETAK	C E T A K 
CHAERUDIN	KH A E R U D I N 
CHAERUL	KH A E R U L 
CHAIRANI	KH A I R A N I 
CHAIRUL	KH A I R U L 
CHALID	KH A L I D 
CHAMSYAH	KH A M SY A H 
CHECK	C E K 
CHECK-OUT	C E K AW T 
CHOI	C OY 
CHOIRIE	KH O I R I 
CHOIRUL	KH O I R U L 
CHOLIL	KH O L I L 
CHOMSYAH	KH O M SY A H 
CHOTIBUL	KH O T I B U L 
CHRISYE	KH R I SY E2 
CIBEUREUM	C I B E2 R E2 M 
CIBINONG	C I B I N O NG 
CICIT	C I C I T 
CIDERA	C I D E2 R A 
CIGANJUR	C I G A NY J U R 
CIHIDEUNG	C I H I D E2 NG 
CIKARANG	C I K A R A NG 
CIKINI	C I K I N I 
CIKOPO	C I K O P O 
CILANDAK	C I L A N D A K 
CILEDUG	C I L E2 D U G 
CILEUNGSI	C I L E2 NG S I 
CILILITAN	C I L I L I T A N 
CINA	C I N A 
CINCIN	C I NY C I N 
CINDERAMATA	C I N D E2 R A M A T A 
CINTA	C I N T A 
CIPARUGPUG	C I P A R U G P U G 
CIPTA	C I P T A 
CIPTAKAN	C I P T A K A N 
CIREBON	C I R E2 B O N 
CIRI	C I R I 
CISADANE	C I S A D A N E 
CISAUK	C I S A U K 
CITEUREUP	C I T E2 R E2 P 
CITRA	C I T R A 
CLURIT	C L U R I T 
COBA	C O B A 
COBA-COBA	C O B A C O B A 
COCA-COLA	K O K A K O L A 
COCOK	C O C O K 
COKLAT	C O K L A T 
COKROAMINOTO	C O K R O A M I N O T O 
COLLECT	K E2 L E K T 
CONTOH	C O N T O H 
CONTOH-CONTOH	C O N T O H C O N T O H 
CONTOHNYA	C O N T O H NY A 
COPOT	C O P O T 
CUACA	C U A C A 
CUCI	C U C I 
CUCU	C U C U 
CUCUNYA	C U C U NY A 
CUEK	C U E K 
CUKAI	C U K AY 
CUKUP	C U K U P 
CULIK	C U L I K 
CUMA	C U M A 
CUPLIKAN	C U P L I K A N 
CURAH	C U R A H 
CURIANNYA	C U R I A N NY A 
CURIGA	C U R I G A 
CURUG	C U R U G 
CUTI	C U T I 
CUTINYA	C U T I NY A 
DAERAH	D A E R A H 
DAERAH-DAERAH	D A E R A H D A E R A H 
DAFTAR	D A F T A R 
DAGANGAN	D A G A NG A N 
DAGANGANNYA	D A G A NG A N NY A 
DAGANG	D A G A NG 
DAGING	D A G I NG 
DAHAKNYA	D A H A K NY A 
DAHSYAT	D A H SY A T 
DAHULU	D A H U L U 
DAIHATSU	D A I H A T S U 
DALAM	D A L A M 
DALAMNYA	D A L A M NY A 
DAMAI	D A M AY 
DAMPAK	D A M P A K 
DANA	D A N A 
DANAU	D A N AW 
DAN	D A N 
DANGDUT	D A NG D U T 
DANIEL	D A N I E L 
DANIRI	D A N I R I 
DAPAT	D A P A T 
DAPATKAH	D A P A T K A H 
DARAH	D A R A H 
DARATAN	D A R A T A N 
DARAT	D A R A T 
DARHAM	D A R H A M 
DARI	D A R I 
DARIPADA	D A R I P A D A 
DARUSSALAM	D A R U S A L A M 
DASAR	D A S A R 
DASARNYA	D A S A R NY A 
DATA	D A T A 
DATANG	D A T A NG 
DATANGNYA	D A T A NG NY A 
DAVID	D A F I D 
DAVIDS	D A F I D S 
DAWAI	D A W AY 
DAYA	D A Y A 
DAYEUHLUHUR	D A Y E2 H L U H U R 
DAYUNG	D A Y U NG 
DEBITOR	D E B I T O R 
DEBU	D E2 B U 
DEDE	D E D E 
DEH	D E H 
DEKAT	D E2 K A T 
DEKLARASI	D E K L A R A S I 
DEKRIT	D E K R I T 
DELAPAN	D E2 L A P A N 
DELEGASI	D E2 L E2 G A S I 
DELISTING	D E2 L I S T I NG 
DEMAM	D E2 M A M 
DEMI	D E2 M I 
DEMIKIAN	D E2 M I K I A N 
DEMISIONER	D E M I S I O N E R 
DEMO	D E M O 
DEMOKRASI	D E M O K R A S I 
DEMONSTRASI	D E M O N S T R A S I 
DENGAN	D E2 NG A N 
DENGAR	D E2 NG A R 
DEPAG	D E2 P A G 
DEPAN	D E2 P A N 
DEPARTEMEN	D E2 P A R T E M E N 
DEPDAGRI	D E P D A G R I 
DEPHUBTEL	D E B H U B T E L 
DEPHUT	D E P H U T 
DEPKEH	D E P K E2 H 
DEPKEU	D E P K E2 U 
DEPLU	D E P L U 
DEPNAKERTRANS	D E P N A K E2 R T R A N S 
DEPPERINDAG	D E P E2 R I N D A G 
DEPUTI	D E P U T I 
DERAS	D E2 R A S 
DERITA	D E2 R I T A 
DESAIN	D E S A I N 
DESAK	D E2 S A K 
DETAIL	D E2 T AY L 
DETAK	D E2 T A K 
DETONATOR	D E T O N A T O R 
DEVELOPER	D E F E2 L O P E2 R 
DEVISA	D E F I S A 
DEWA	D E W A 
DEWAN	D E W A N 
DEWASA	D E W A S A 
DEWI	D E W I 
DIABETES	D I A B E T E S 
DIA	D I A 
DIAJUKAN	D I K A J U K A N 
DIAKTIFKAN	D I K A K T I F K A N 
DIAKUI	D I K A K U I 
DIAKUINYA	D I K A K U I NY A 
DIALAMATKAN	D I K A L A M A T K A N 
DIALAMI	D I K A L A M I 
DIALAMINYA	D I K A L A M I NY A 
DIALIHKAN	D I K A L I H K A N 
DIALIRKAN	D I K A L I R K A N 
DIALOG	D I A L O G 
DIAM-DIAM	D I A M D I A M 
DIANGGAP	D I K A NG G A P 
DIANGKAT	D I K A NG K A T 
DIANGKUT	D I K A NG K U T 
DIANTARANYA	D I K A N T A R A NY A 
DIARE	D I A R E 
DIASRAMAKAN	D I K A S R A M A K A N 
DIATUR	D I K A T U R 
DIBACA	D I B A C A 
DIBAHAS	D I B A H A S 
DIBAKAR	D I B A K A R 
DIBANDING	D I B A N D I NG 
DIBANDINGKAN	D I B A N D I NG K A N 
DIBARENGI	D I B A R E2 NG I 
DIBAWA	D I B A W A 
DIBAWAH	D I B A W A H 
DIBAWANYA	D I B A W A NY A 
DIBAYARKAN	D I B A Y A R K A N 
DIBERI	D I B E2 R I 
DIBERIKAN	D I B E2 R I K A N 
DIBERITAKAN	D I B E2 R I T A K A N 
DIBERSIHKAN	D I B E2 R S I H K A N 
DIBILANG	D I B I L A NG 
DIBONCENG	D I B O NY C E NG 
DIBONGKAR	D I B O NG K A R 
DIBOPONG	D I B O P O NG 
DIBORGOL	D I B O R G O L 
DIBORONG	D I B O R O NG 
DIBUANG	D I B U A NG 
DIBUAT	D I B U A T 
DIBUNYIKAN	D I B U NY I K A N 
DICABUT	D I C A B U T 
DICUCI	D I C U C I 
DICURI	D I C U R I 
DIDAMPINGI	D I D A M P I NG I 
DIDAPAT	D I D A P A T 
DIDATANGI	D I D A T A NG I 
DI	D I 
DIDIAGNOSIS	D I D I A G N O S I S 
DIDIK	D I D I K 
DIDIKTE	D I D I K T E 
DIDORONG	D I D O R O NG 
DIDORONG-DORONG	D I D O R O NG D O R O NG 
DIDUGA	D I D U G A 
DIDUKUNG	D I D U K U NG 
DIENG	D I E NG 
DIEVAKUASI	D I K E F A K U A S I 
DIGANTI	D I G A N T I 
DIGELAR	D I G E2 L A R 
DIGOLONGKAN	D I G O L O NG K A N 
DIGONCANG	D I G O NY C A NG 
DIGUBRIS	D I G U B R I S 
DIGUNAKAN	D I G U N A K A N 
DIHADAPI	D I H A D A P I 
DIHALAU	D I H A L AW 
DIHAMBAT	D I H A M B A T 
DIHARAPKAN	D I H A R A P K A N 
DIHEMPAS	D I H E2 M P A S 
DIHENTIKAN	D I H E2 N T I K A N 
DIHIMBAU	D I H I M B AW 
DIHUBUNGI	D I H U B U NG I 
DIIDENTIFIKASI	D I K I D E N T I F I K A S I 
DIIMBAU	D I K I M B AW 
DIINGATKAN	D I K I NG A T K A N 
DIIRINGI	D I K I R I NG I 
DIISI	D I K I S I 
DIIZINKAN	D I K I Z I N K A N 
DIJADIKAN	D I J A D I K A N 
DIJADWALKAN	D I J A D W A L K A N 
DIJAMBRET	D I J A M B R E T 
DIJANGKAU	D I J A NG K AW 
DIJATUHKAN	D I J A T U H K A N 
DIJAWAB	D I J A W A B 
DIJEBLOSKAN	D I J E2 B L O S K A N 
DIJEMPUT	D I J E2 M P U T 
DIJUAL	D I J U A L 
DIJUMPAI	D I J U M P A I 
DIJUNJUNG	D I J U NY J U NG 
DIKATAKAN	D I K A T A K A N 
DIKAWAL	D I K A W A L 
DIKEBUMIKAN	D I K E2 B U M I K A N 
DIKELOLA	D I K E2 L O L A 
DIKELUARKAN	D I K E2 L U A R K A N 
DIKEMUDIKAN	D I K E2 M U D I K A N 
DIKENAKAN	D I K E2 N A K A N 
DIKENAL	D I K E2 N A L 
DIKENDARAI	D I K E2 N D A R A I 
DIKETUAI	D I K E2 T U A I 
DIKHAWATIRKAN	D I KH A W A T I R K A N 
DIKIRIM	D I K I R I M 
DIKIRIMKAN	D I K I R I M K A N 
DIKLASIFIKASIKAN	D I K L A S I F I K A S I K A N 
DIKONSENTRASIKAN	D I K O N S E N T R A S I K A N 
DIKUTIP	D I K U T I P 
DILAKSANAKAN	D I L A K S A N A K A N 
DILAKUKAN	D I L A K U K A N 
DILAKUKANNYA	D I L A K U K A N NY A 
DILALUI	D I L A L U I 
DILANDA	D I L A N D A 
DILANJUTKAN	D I L A NY J U T K A N 
DILAPORKAN	D I L A P O R K A N 
DILECEHKAN	D I L E C E H K A N 
DILEPAS	D I L E2 P A S 
DILERAI	D I L E2 R AY 
DILETAKKAN	D I L E2 T A K K A N 
DILIBATKAN	D I L I B A T K A N 
DILIHAT	D I L I H A T 
DIMAKSUD	D I M A K S U D 
DIMAKSUDKAN	D I M A K S U D K A N 
DIMASAK	D I M A S A K 
DIMINTAI	D I M I N T A I 
DIMUAT	D I M U A T 
DIMULAI	D I M U L A I 
DINAMIKA	D I N A M I K A 
DINDING	D I N D I NG 
DINILAI	D I N I L AY 
DINILAINYA	D I N I L AY NY A 
DINYATAKAN	D I NY A T A K A N 
DIOPERASI	D I K O P E2 R A S I 
DIPAKAI	D I P A K AY 
DIPAKSAKAN	D I P A K S A K A N 
DIPANDANG	D I P A N D A NG 
DIPANGGIL	D I P A NG G I L 
DIPASTIKAN	D I P A S T I K A N 
DIPEGANG	D I P E G A NG 
DIPENUHI	D I P E2 N U H I 
DIPENUHINYA	D I P E2 N U H I NY A 
DIPERBAIKI	D I P E2 R B A I K I 
DIPERCAYA	D I P E2 R C A Y A 
DIPERIKSA	D I P E2 R I K S A 
DIPERKIRAKAN	D I P E2 R K I R A K A N 
DIPERLUKAN	D I P E2 R L U K A N 
DIPEROLEH	D I P E2 R O L E H 
DIPERPARAH	D I P E2 R P A R A H 
DIPERSIAPKAN	D I P E2 R S I A P K A N 
DIPERTAHANKAN	D I P E2 R T A H A N K A N 
DIPICU	D I P I C U 
DIPILIH	D I P I L I H 
DIPIMPIN	D I P I M P I N 
DIPINDAHKAN	D I P I N D A H K A N 
DIPLOMATIK	D I P L O M A T I K 
DIPOSKAN	D I P O S K A N 
DIPOTONG	D I P O T O NG 
DIPOTRET	D I P O T R E T 
DIPUBLIKASIKAN	D I P U B L I K A S I K A N 
DIPUJI	D I P U J I 
DIPUKUL	D I P U K U L 
DIPULIHKAN	D I P U L I H K A N 
DIPUSATKAN	D I P U S A T K A N 
DIPUTAR	D I P U T A R 
DIRAMAIKAN	D I R A M AY K A N 
DIRAMPOK	D I R A M P O K 
DIRASA	D I R A S A 
DIREKTUR	D I R E K T U R 
DIRI	D I R I 
DIRINYA	D I R I NY A 
DIRJEN	D I R J E N 
DISAMBUT	D I S A M B U T 
DISAMPAIKAN	D I S A M P AY K A N 
DISAMPING	D I S A M P I NG 
DISEBUT	D I S E2 B U T 
DISEBUTKAN	D I S E2 B U T K A N 
DISEDOT	D I S E2 D O T 
DISEGEL	D I S E G E2 L 
DISELESAIKAN	D I S E2 L E2 S AY K A N 
DISELINGI	D I S E2 L I NG I 
DISERAHKAN	D I S E2 R A H K A N 
DISERANG	D I S E2 R A NG 
DISETUJUI	D I S E2 T U J U I 
DISIAPKAN	D I S I A P K A N 
DISIMPAN	D I S I M P A N 
DISINGGUNG	D I S I NG G U NG 
DISIPLIN	D I S I P L I N 
DISITA	D I S I T A 
DISKON	D I S K O N 
DISKORS	D I S K O R S 
DISKRIMINATIF	D I S K R I M I N A T I F 
DISNEYLAND	D I S N I L A N 
DISULAP	D I S U L A P 
DISUPLAI	D I S U P L EY 
DISUSUN	D I S U S U N 
DISYUKURI	D I SY U K U R I 
DITAFSIRKAN	D I T A F S I R K A N 
DITAHAN	D I T A H A N 
DITAHANNYA	D I T A H A N NY A 
DITAMPUNG	D I T A M P U NG 
DITANDATANGANI	D I T A N D A T A NG A N I 
DITANGGAPI	D I T A NG G A P I 
DITANGKAP	D I T A NG K A P 
DITANYA	D I T A NY A 
DITARGETKAN	D I T A R G E T K A N 
DITARIK	D I T A R I K 
DITAYANGKAN	D I T A Y A NG K A N 
DITEGUR	D I T E2 G U R 
DITEMPUH	D I T E2 M P U H 
DITEMUI	D I T E2 M U I 
DITEMUKAN	D I T E2 M U K A N 
DITENGARAI	D I T E2 NG A R AY 
DITENTUKAN	D I T E2 N T U K A N 
DITEPATI	D I T E2 P A T I 
DITERIMA	D I T E2 R I M A 
DITETAPKAN	D I T E2 T A P K A N 
DITILANG	D I T I L A NG 
DITINJAU	D I T I NY J AW 
DITODONG	D I T O D O NG 
DITOLAK	D I T O L A K 
DITSERSE	D I T S E R S E2 
DITUDUH	D I T U D U H 
DITUJUKAN	D I T U J U K A N 
DITULIS	D I T U L I S 
DITUNGGU	D I T U NG G U 
DITUNTASKAN	D I T U N T A S K A N 
DITUTUP	D I T U T U P 
DIUANGKAN	D I K U A NG K A N 
DIUBAH	D I K U B A H 
DIUPAYAKAN	D I K U P A Y A K A N 
DIURAIKAN	D I K U R AY K A N 
DIVONIS	D I F O N I S 
DIWAKILI	D I W A K I L I 
DIWARNAI	D I W A R N A I 
DIWAWANCARAI	D I W A W A NY C A R A I 
DIY	D E K I Y E 
DJAELANI	J A E L A N I 
DKI	D E K A K I 
DODI	D O D I 
DODO	D O D O 
DOKTER	D O K T E2 R 
DOKUMENTASI	D O K U M E N T A S I 
DOLAR	D O L A R 
DONG	D O NG 
DORAEMON	D O R A E M O N 
DOSIS	D O S I S 
DPRD	D E P E K E R D E 
DPR	D E P E K E R 
DRAF	D R A F 
DRAINASE	D R AY N A S E2 
DRAMATIS	D R A M A T I S 
DRY-CLEAN	D R AY K L I N 
DUA	D U A 
DUALISME	D U A L I S M E2 
DUBES	D U B E2 S 
DUDUK	D U D U K 
DUDUK-DUDUK	D U D U K D U D U K 
DUDUKNYA	D U D U K NY A 
DUET	D U E T 
DUGAAN	D U G A K A N 
DUGAANNYA	D U G A K A N NY A 
DUKUNGAN	D U K U NG A N 
DULU	D U L U 
DULUNYA	D U L U NY A 
DUNIA	D U N I A 
DUPA	D U P A 
DUR	D U R 
DUTA	D U T A 
DWIKARNA	D W I K A R N A 
DWIKEWARGANEGARAAN	D W I K E2 W A R G A N E2 G A R A K A N 
DZUHUR	D Z U H U R 
EARPHONE	I R F O N 
EBTANAS	E B T A N A S 
ECERAN	E C E R A N 
EDARAN	E D A R A N 
EDDY	E D I 
EDGAR	E D G A R 
EDISI	E D I S I 
EDITOR	E D I T O R 
EDUARDO	E D U A R D O 
EDY	E D I 
EEP	E K E P 
EFEKNYA	E F E K NY A 
EFEKTIF	E F E K T I F 
EFEKTIFNYA	E F E K T I F NY A 
EFFENDY	E F E N D I 
EGALITER	E G A L I T E R 
EGGI	E G I 
EGI	E G I 
EGO	E G O 
EGOISME	E G O I S M E2 
EH	E H 
EJEKAN	E J E K A N 
EKKI	E K I 
EKONOMI	E K O N O M I 
EKSEKUTIF	E K S E2 K U T I F 
EKSEKUTIF-LEGISLATIF	E K S E K U T I F L E G I S L A T I F 
EKSEKUTOR	E K S E2 K U T O R 
EKSKLUSIF	E K S K L U S I F 
EKSPLISIT	E K S P L I S I T 
EKSPLOITASI	E K S P L O I T A S I 
EKSPOR	E K S P O R 
EKSTENSIFIKASI	E K S T E N S I F I K A S I 
EKS-TIMOR	E K S T I M O R 
ELAKNYA	E2 L A K NY A 
ELANG	E2 L A NG 
ELEKTRONIK	E L E K T R O N I K 
EL	E L 
ELEMEN	E L E2 M E N 
ELIMINASI	E L I M I N A S I 
ELITE	E L I T 
ELIZA	E L I Z A 
ELSA	E L S A 
ELSHINTA	E L S I N T A 
ELSYA	E L SY A 
ELVIS	E L F I S 
ELZA	E L Z A 
EMAIL	I M EY L 
EMANUEL	E M A N U E L 
EMAS	E2 M A S 
EMBARGO	E M B A R G O 
EMBONG	E M B O NG 
EMIR	E M I R 
EMITEN	E M I T E N 
EMPAT	E2 M P A T 
ENAK	E N A K 
ENAM	E2 N A M 
ENDO	E N D O 
ENDRIARTONO	E N D R I A R T O N O 
ENERGI	E N E R G I 
ENGGAK	E2 NG G A K 
ENGGAN	E2 NG G A N 
ENGGARTIASTO	E NG G A R T I A S T O 
ENICO	E N I K O 
ENJAM	E2 NY J A M 
ENTAHLAH	E2 N T A H L A H 
ENTOY	E N T OY 
ENYAM	E2 NY A M 
EPISODE	E P I S O D E2 
ERA	E R A 
ERAT	E2 R A T 
ERMITA	E R M I T A 
EROPA	E R O P A 
EROSS	E R O S 
ESAI	E S AY 
ES	E S 
ESOK	E S O K 
ESTER	E S T E R 
ETALASE	E T A L A S E2 
ETIKA	E T I K A 
ETIK	E T I K 
ETNIK	E T N I K 
ETNIS	E T N I S 
ETNISITAS	E T N I S I T A S 
EULIS	E2 L I S 
EURICO	E U R I K O 
EUTHANASIA	E U T A N A S I A 
EVAKUASI	E F A K U A S I 
EVALUASI	E F A L U A S I 
EVI	E F I 
FACHMI	F A KH M I 
FACHRI	F A K H R I 
FADEL	F A D E L 
FAHMI	F A H M I 
FAISAL	F A I S A L 
FAJRUL	F A J R U L 
FAKSIMILE	F A K S I M I L 
FAKTA	F A K T A 
FAKTOR	F A K T O R 
FANATIK	F A N A T I K 
FANS	F A N S 
FANTASTIS	F A N T A S T I S 
FARHAN	F A R H A N 
FARIKHA	F A R I KH A 
FARIZ	F A R I Z 
FARMA	F A R M A 
FASIH	F A S I H 
FASILITAS	F A S I L I T A S 
FATAH	F A T A H 
FATHUR	F A T U R 
FATMAWATI	F A T M A W A T I 
FAUZI	F A U Z I 
FAVORIT	F A F O R I T 
FAVORITNYA	F A F O R I T NY A 
FAX	F E K S 
FAZRI	F A Z R I 
FBR	E F B E K E R 
FEBRUARI	F E B R U A R I 
FEDERAL	F E D E2 R A L 
FEDERASI	F E D E2 R A S I 
FEISAL	F E I S A L 
FELIX	F E L I K S 
FENG	F E NG 
FEODAL	F E O D A L 
FERDINANDUS	F E R D I N A N D U S 
FERI	F E R I 
FEROZA	F E R O Z A 
FERRY	F E R I 
FESTIVAL	F E S T I F A L 
FIGUR	F I G U R 
FIJI	F I J I 
FILIPINA	F I L I P I N A 
FILM	F I L E2 M 
FILM-FILM	F I L E2 M F I L E2 M 
FILMNYA	F I L E2 M NY A 
FILOSOFI	F I L O S O F I 
FILSUF	F I L S U F 
FINAL	F I N A L 
FIRAUN	F I R AW N 
FISIK	F I S I K 
FISIP	F I S I P 
FLEKSIBEL	F L E K S I B E2 L 
FLORAT	F L O R A T 
FLORES	F L O R E S 
FLORIDA	F L O R I D A 
FLUKTUATIF	F L U K T U A T I F 
FOKUS	F O K U S 
FORMAL	F O R M A L 
FORMALITAS	F O R M A L I T A S 
FORMAT	F O R M A T 
FORMULIR	F O R M U L I R 
FORTUNA	F O R T U N A 
FORUM	F O R U M 
FOTO	F O T O 
FOTO-FOTO	F O T O F O T O 
FOTOGRAFER	F O T O G R A F E2 R 
FPDIP	E F P E D E K I P E 
FRAGMENTASI	F R A G M E N T A S I 
FRAKSI	F R A K S I 
FRAKSI-FRAKSI	F R A K S I F R A K S I 
FRANCISCO	F R A N S I S K O 
FRANKFURT	F R A NG F U R T 
FRANS	F R A N S 
FREEPORT	F R I P O R T 
FREKUENSI	F R E K U E N S I 
FREKWENSI	F R E K W E N S I 
FRETILIN	F R E T I L I N 
FRIETS	F R I T S 
FRONT	F R O N 
FRUSTRASI	F R U S T R A S I 
FUAD	F U K A D 
FUJIWARA	F U J I W A R A 
FUNDAMENTAL	F U N D A M E N T A L 
FUNGSI	F U NG S I 
FUNGSIONARIS	F U NG S I O N A R I S 
FUTSAL	F U T S A L 
GABUNGAN	G A B U NG A N 
GADE	G EY D 
GADING	G A D I NG 
GADIS	G A D I S 
GADO-GADO	G A D O G A D O 
GAFUR	G A F U R 
GAGAL	G A G A L 
GAGASAN	G A G A S A N 
GAJI	G A J I 
GALON	G A L O N 
GAMBIR	G A M B I R 
GAMBLANG	G A M B L A NG 
GAM	G A M 
GANGGUAN	G A NG G U A N 
GAPENSI	G A P E N S I 
GARA-GARA	G A R A G A R A 
GARAM	G A R A M 
GARANSI	G A R A N S I 
GARIS	G A R I S 
GARUDA	G A R U D A 
GARUT	G A R U T 
GAS	G A S 
GAWE	G A W E 
GAYA	G A Y A 
GAZALI	G A Z A L I 
GEBYAR	G E2 B Y A R 
GEDE	G E2 D E 
GEDONG	G E2 D O NG 
GEDUNG	G E2 D U NG 
GEGAP	G E2 G A P 
GEGER	G E G E R 
GEJALA	G E2 J A L A 
GEJOLAK	G E2 J O L A K 
GELAP	G E2 L A P 
GELOMBANG	G E2 L O M B A NG 
GEMBIRA	G E2 M B I R A 
GEMPITA	G E2 M P I T A 
GEMPOL	G E2 M P O L 
GENCARNYA	G E2 NY C A R NY A 
GENDUT	G E2 N D U T 
GENERASI	G E2 N E2 R A S I 
GENGGAM	G E2 NG G A M 
GENG	G E NG 
GENTENG	G E2 N T E NG 
GEODESI	G E O D E S I 
GEOFISIKA	G E O F I S I K A 
GEPOKAN	G E P O K A N 
GERAI-GERAI	G E2 R AY G E2 R AY 
GERAKAN	G E2 R A K A N 
GERAK	G E2 R A K 
GERBONG	G E2 R B O NG 
GEREJA	G E2 R E J A 
GERETAN	G E R E T A N 
GERUNGAN	G E2 R U NG A N 
GESEKAN	G E S E K A N 
GHAIB	G A K I B 
GHUFRON	G U F R O N 
GIGI	G I G I 
GIMANA	G I M A N A 
GINANJAR	G I N A NY J A R 
GINSENG	G I N S E NG 
GINTINGS	G I N T I NG S 
GIRO	G I R O 
GITAR	G I T A R 
GITU	G I T U 
GIULIANI	G I U L I A N I 
GIZI	G I Z I 
GIZINYA	G I Z I NY A 
GLASGOW	G L A S G O W 
GLENN	G L E N 
GLENYENGAN	G L E2 NY E2 NG A N 
GLOBAL	G L O B A L 
GLOBALISASI	G L O B A L I S A S I 
GLODOK	G L O D O K 
GLONGGONGAN	G L O NG G O NG A N 
GLUTAMAT	G L U T A M A T 
GOA	G O A 
GOBEL	G O B E L 
GOLF	G O L F 
GOLFNYA	G O L F NY A 
GOL	G O L 
GOLKAR	G O L K A R 
GOLOK	G O L O K 
GONDRONG	G O N D R O NG 
GONZALES	G O N Z A L E2 S 
GORENG	G O R E NG 
GORO	G O R O 
GORONTALO	G O R O N T A L O 
GOTONG	G O T O NG 
GRACE	G R EY S 
GRANAT	G R A N A T 
GRATIS	G R A T I S 
GRESIK	G R E2 S I K 
GROSIR	G R O S I R 
GRUP	G R U P 
GRUSA-GRUSU	G R U S A G R U S U 
GUBERNUR	G U B E2 R N U R 
GUBERNURNYA	G U B E2 R N U R NY A 
GUDANG	G U D A NG 
GUE	G U E 
GUGATAN	G U G A T A N 
GUGUP	G U G U P 
GULTOM	G U L T O M 
GUNA	G U N A 
GUNAKAN	G U N A K A N 
GUNTING	G U N T I NG 
GUNUNG	G U N U NG 
GURAUNYA	G U R AW NY A 
GURU	G U R U 
GUS	G U S 
GUSMARDI	G U S M A R D I 
HABIB	H A B I B 
HABIBIE	H A B I B I 
HABIS	H A B I S 
HADAD	H A D A D 
HADAPAN	H A D A P A N 
HADI	H A D I 
HADIR	H A D I R 
HADIRIN	H A D I R I N 
HAFIZ	H A F I S 
HAI	H AY 
HAJI	H A J I 
HAK	H A K 
HAKIM	H A K I M 
HALAMAN	H A L A M A N 
HALAMANNYA	H A L A M A N NY A 
HAL	H A L 
HALIM	H A L I M 
HALO	H A L O 
HALTE	H A L T E2 
HALTE-HALTE	H A L T E2 H A L T E2 
HAMAD	H A M A D 
HAMDANI	H A M D A N I 
HAM	H A M 
HAMID	H A M I D 
HAMPIR	H A M P I R 
HAMZAH	H A M Z A H 
HANAFIE	H A N A F I 
HANDAI	H A N D AY 
HANGSENG	H A NG S E NG 
HANYA	H A NY A 
HANYUT	H A NY U T 
HAPUS	H A P U S 
HARAPAN	H A R A P A N 
HARCO	H A R K O 
HARGA	H A R G A 
HARGA-HARGA	H A R G A H A R G A 
HARGANYA	H A R G A NY A 
HARI	H A R I 
HARIMAU	H A R I M AW 
HARINYA	H A R I NY A 
HARKRISNOWO	H A R K R I S N O W O 
HARKRISTUTI	H A R K R I S T U T I 
HARMAYN	H A R M AY N 
HARTO	H A R T O 
HARUS	H A R U S 
HARUSNYA	H A R U S NY A 
HARVEY	H A R F EY 
HARYANTO	H A R Y A N T O 
HASAN	H A S A N 
HASBALAH	H A S B A L A H 
HASIL	H A S I L 
HASILNYA	H A S I L NY A 
HASSAN	H A S A N 
HASYIM	H A SY I M 
HATI	H A T I 
HATI-HATI	H A T I H A T I 
HATIKU	H A T I K U 
HATTA	H A T A 
HAUL	H A U L 
HAWA	H A W A 
HAZLI	H A Z L I 
HEADPHONE	H E D F O N 
HEBAT	H E B A T 
HEBATNYA	H E B A T NY A 
HEHAMAHUA	H E H A M A H U A 
HEI	H EY 
HEKTAR	H E K T A R 
HELIKOPTER	H E L I K O P T E2 R 
HELIPED	H E L I P E D 
HENDAK	H E2 N D A K 
HENDAKNYA	H E2 N D A K NY A 
HENDRA	H E N D R A 
HENDRAJIT	H E N D R A J I T 
HENDRAWAN	H E N D R A W A N 
HENDRO	H E N D R O 
HENGKANG	H E NG K A NG 
HENING	H E2 N I NG 
HENTIKAN	H E2 N T I K A N 
HEPPI	H E P I 
HERAN	H E R A N 
HERMAN	H E R M A N 
HERNA	H E R N A 
HEROIN	H E R O I N 
HERWIDAYATMO	H E R W I D A Y A T M O 
HEWAN	H E W A N 
HIBURAN	H I B U R A N 
HIDETOSHI	H I D E T O SY I 
HIDUP	H I D U P 
HIDUP-HIDUP	H I D U P H I D U P 
HIDUPNYA	H I D U P NY A 
HIJAU	H I J AW 
HIJAUNYA	H I J AW NY A 
HIJRAH	H I J R A H 
HIKAM	H I K A M 
HILANG	H I L A NG 
HIMBAUAN	H I M B AW A N 
HINGGA	H I NG G A 
HIRAU	H I R AW 
HITAM	H I T A M 
HMM	EY C E M E M 
HOBI	H O B I 
HOEGENG	H U G E2 NG 
HOESAINY	H U S A I N I 
HOIRIAH	H O I R I A H 
HONGARIA	H O NG A R I A 
HONGKONG	H O NG K O NG 
HONORER	H O N O R E R 
HORISONTAL	H O R I S O N T A L 
HORIZON	H O R I Z O N 
HOS	H O S 
HOTEL	H O T E L 
HOUSE	H AW S 
HOWARD	H O W E2 R T 
HUBBLE	H A B E2 L 
HUBUNGAN	H U B U NG A N 
HUJAN	H U J A N 
HUKUM	H U K U M 
HUKUMNYA	H U K U M NY A 
HUMAS	H U M A S 
HURUF	H U R U F 
HURUF-HURUF	H U R U F H U R U F 
HUSEIN	H U S E I N 
HUSODO	H U S O D O 
HUTAN	H U T A N 
IA	I A 
IALAH	I A L A H 
IBADAH	I B A D A H 
IBARATNYA	I B A R A T NY A 
IBNU	I B N U 
IBU	I B U 
IBUNDA	I B U N D A 
IBUNYA	I B U NY A 
ICHIRO	I C I R O 
ICHLASUL	I KH L A S U L 
ICHRAM	I KH R A M 
ICHSAN	I KH S A N 
ICHWAN	I KH W A N 
IDE	I D E 
IDEOLOGIS	I D E O L O G I S 
IDHAM	I D A M 
IDRIS	I D R I S 
IGUACU	I G U A C U 
IHSG	I H A K E S G E 
IHWAL	I H W A L 
IHZA	I H Z A 
IJAZAH	I J A Z A H 
IJIN	I J I N 
IKAN	I K A N 
IKHDAN	I KH D A N 
IKHLAS	I KH L A S 
IKIP	I K I P 
IKLIM	I K L I M 
IKUTI	I K U T I 
IKUT	I K U T 
ILEGAL	I L E G A L 
ILLAHI	I L A H I 
ILMU	I L M U 
ILMUWAN	I L M U W A N 
ILYAS	I L Y A S 
IMAJINASINYA	I M A J I N A S I NY A 
IMAM	I M A M 
IMAN	I M A N 
IMBAU	I M B AW 
IMB	I K E M B E 
IMBUH	I M B U H 
IMEJ	I M E J 
IMF	I K E M E F 
IMLEK	I M L E K 
IMPOR	I M P O R 
IMRON	I M R O N 
INAP	I N A P 
INDEKS	I N D E K S 
INDEPENDEN	I N D E2 P E2 N D E2 N 
INDIA	I N D I A 
INDIKASI	I N D I K A S I 
INDIVIDU	I N D I F I D U 
INDOCINA	I N D O C I N A 
INDOFOOD	I N D O F U D 
INDOLIFE	I N D O L AY F 
INDONESIA-AS	I N D O N E S I A A E S 
INDONESIA	I N D O N E S I A 
INDRIYANTO	I N D R I Y A N T O 
INDUSTRI	I N D U S T R I 
INEFISIENSI	I N E F I S I E N S I 
INFO	I N F O 
INFORMASI	I N F O R M A S I 
INFUS	I N F U S 
INGAT	I NG A T 
INGGRIS	I NG G R I S 
INGIN	I NG I N 
INI	I N I 
INI-ITU	I N I I T U 
INILAH	I N I L A H 
INISIATIF	I N I S I A T I F 
INSANG	I N S A NG 
INSPEKTUR	I N S P E K T U R 
INSTALASI	I N S T A L A S I 
INSTITUSI	I N S T I T U S I 
INSTITUT	I N S T I T U T 
INSTRUKTUR	I N S T R U K T U R 
INSYAF	I NY SY A F 
INTERAKTIF	I N T E2 R A K T I F 
INTERLOKAL	I N T E2 R L O K A L 
INTERNASIONAL	I N T E2 R N A S I O N A L 
INTERPELASI	I N T E2 R P E2 L A S I 
INTERUPSI	I N T E2 R U P S I 
INTI	I N T I 
INVENTARISASI	I N F E N T A R I S A S I 
INVESTASI	I N F E S T A S I 
INVESTOR	I N F E S T O R 
IPTU	I P T U 
IRAK	I R A K 
IRAMASUKA	I R A M A S U K A 
IRAWAN	I R A W A N 
IRENG	I R E2 NG 
IRIANJAYA	I R I A NY J A Y A 
IRISAN	I R I S A N 
IRJA	I R J A 
IRWANSYAH	I R W A NY SY A H 
ISA	I S A 
ISHIDA	I SY I D A 
ISI	I S I 
ISILAH	I S I L A H 
ISINYA	I S I NY A 
ISKANDAR	I S K A N D A R 
ISLAM	I S L A M 
ISLAMIYAH	I S L A M I Y A H 
ISMAIL	I S M A K I L 
ISOLASI	I S O L A S I 
ISRAEL	I S R A E L 
ISTANA	I S T A N A 
ISTIGFAR	I S T I G F A R 
ISTILAH	I S T I L A H 
ISTIMEWA	I S T I M E W A 
ISTRI	I S T R I 
ISTRINYA	I S T R I NY A 
ISU	I S U 
ISU-ISU	I S U I S U 
ISYARATKAN	I SY A R A T K A N 
ITALIA	I T A L I A 
ITB	I T E B E 
ITU	I T U 
ITU-ITU	I T U I T U 
ITULAH	I T U L A H 
IURAN	I U R A N 
IWAN	I W A N 
IYA	I Y A 
IZIN	I Z I N 
IZINKANLAH	I Z I N K A N L A H 
IZINNYA	I Z I N NY A 
JABATAN	J A B A T A N 
JACOEB	Y A K U B 
JADI	J A D I 
JADWAL	J A D W A L 
JAENUDIN	J A E N U D I N 
JAFAR	J A F A R 
JAJARAN	J A J A R A N 
JAKARTA	J A K A R T A 
JAKSA	J A K S A 
JAKSEL	J A K S E2 L 
JALANAN	J A L A N A N 
JALAN	J A L A N 
JALAN-JALAN	J A L A N J A L A N 
JALANNYA	J A L A N NY A 
JALUR	J A L U R 
JAMAAH	J A M A K A H 
JAMAL	J A M A L 
JAMBI	J A M B I 
JAM	J A M 
JAMUR	J A M U R 
JANGAN	J A NG A N 
JANGKAUAN	J A NG K AW A N 
JANJI-JANJI	J A NY J I J A NY J I 
JANJI	J A NY J I 
JANUARI	J A N U A R I 
JARAK	J A R A K 
JARI	J A R I 
JARINGAN	J A R I NG A N 
JASA	J A S A 
JATENG	J A T E2 NG 
JATIM	J A T I M 
JATIUWUNG	J A T I U W U NG 
JATUH	J A T U H 
JAUH	J A U H 
JAWABAN	J A W A B A N 
JAWAB	J A W A B 
JAWA	J A W A 
JAYADI	J A Y A D I 
JAYA	J A Y A 
JAYAPURA-WAMENA	J A Y A P U R A W A M E N A 
JAZED	J A Z E D 
JEBLOK	J E2 B L O K 
JEDA	J E2 D A 
JEDDAH	J E D A H 
JEGAL	J E G A L 
JEJAK	J E2 J A K 
JELAS	J E2 L A S 
JELEK	J E2 L E K 
JEMAAH	J E2 M A K A H 
JEMBATAN	J E2 M B A T A N 
JEMBER	J E2 M B E2 R 
JENASAH	J E2 N A S A H 
JENAZAH	J E2 N A Z A H 
JENDELA	J E2 N D E L A 
JENDERAL	J E N D E2 R A L 
JENDRAL	J E N D R A L 
JENEPONTO	J E N E P O N T O 
JENGGOT	J E NG G O T 
JENIS	J E2 N I S 
JENIS-JENIS	J E2 N I S J E2 N I S 
JENJANG	J E2 NY J A NG 
JEPANG	J E2 P A NG 
JEPARA	J E2 P A R A 
JERA	J E2 R A 
JERMAN	J E R M A N 
JERNIH	J E2 R N I H 
JERUSALEM	Y E R U S A L E M 
JIANG	J I A NG 
JIHAD	J I H A D 
JIHANDAK	J I H A N D A K 
JIKA	J I K A 
JILID	J I L I D 
JIMBARAN	J I M B A R A N 
JINJING	J I NY J I NG 
JIWA	J I W A 
JOGJA	J O G J A 
JOJO	J O J O 
JOKO	J O K O 
JOMBANG	J O M B A NG 
JOMPO	J O M P O 
JONGOS	J O NG O S 
JORDAN	J O R D A N 
JOSEF	J O S E F 
JOSIS	J O S I S 
JUAL	J U A L 
JUANDA	J U A N D A 
JUARA	J U A R A 
JUDI	J U D I 
JUDUL	J U D U L 
JUFRI	J U F R I 
JUGA	J U G A 
JULUKAN	J U L U K A N 
JUMAT	J U M A T 
JUMLAH	J U M L A H 
JUMLAHNYA	J U M L A H NY A 
JUMPA	J U M P A 
JUNAEDI	J U N A E D I 
JUNDULLAH	J U N D U L A H 
JUNI	J U N I 
JUNTRUNGANNYA	J U N T R U NG A N NY A 
JUORO	J U O R O 
JURUSAN	J U R U S A N 
JUS	J U S 
JUSTRU	J U S T R U 
JUSUF	Y U S U F 
JUTA	J U T A 
JUWONO	J U W O N O 
KABAG	K A B A G 
KABAR	K A B A R 
KABEL-KABEL	K A B E2 L K A B E2 L 
KABINET	K A B I N E T 
KABUPATEN	K A B U P A T E N 
KABUR	K A B U R 
KABUYUTAN	K A B U Y U T A N 
KACA	K A C A 
KACAMATA	K A C A M A T A 
KACANG-KACANGAN	K A C A NG K A C A NG A N 
KACAU-BALAU	K A C AW B A L AW 
KACAU	K A C AW 
KACUNG	K A C U NG 
KADANG-KADANG	K A D A NG K A D A NG 
KADER	K A D E2 R 
KADERNYA	K A D E2 R NY A 
KADITSERSE	K A D I T S E R S E2 
KAGETKAN	K A G E T K A N 
KAHAYAN	K A H A Y A N 
KAHFI	K A H F I 
KAIMOEDDIN	K A I M U D I N 
KAITAN	K A I T A N 
KAJARI	K A J A R I 
KAKI	K A K I 
KALAH	K A L A H 
KALANGAN	K A L A NG A N 
KALAU	K A L AW 
KALAUPUN	K A L AW P U N 
KALEB	K A L E2 B 
KALEM	K A L E2 M 
KALENG	K A L E NG 
KALIFORNIA	K A L I F O R N I A 
KALI	K A L I 
KALKUN	K A L K U N 
KALLA	K A L A 
KALSEL	K A L S E2 L 
KALSIUM	K A L S I U M 
KALUNG	K A L U NG 
KAMALUDDIN	K A M A L U D I N 
KAMAR	K A M A R 
KAMARNYA	K A M A R NY A 
KAMARUZZAMAN	K A M A R U Z A M A N 
KAMBOJA	K A M B O J A 
KAMERA	K A M E R A 
KAMI	K A M I 
KAMIS	K A M I S 
KAMPANYE	K A M P A NY E2 
KAMPUNG	K A M P U NG 
KAMTIB	K A M T I B 
KAMU	K A M U 
KANDAS	K A N D A S 
KANDUNG	K A N D U NG 
KANINDOTEX	K A N I N D O T E K S 
KANJI	K A NY J I 
KAN	K A N 
KANKER	K A NG K E2 R 
KANS	K A N S 
KANTOR	K A N T O R 
KANVAS	K A N F A S 
KANWIL	K A N W I L 
KAPAL	K A P A L 
KAPANKAH	K A P A N K A H 
KAPAN	K A P A N 
KAPASITAS	K A P A S I T A S 
KAPAU	K A P AW 
KAPITALISME	K A P I T A L I S M E2 
KAPOLDA	K A P O L D A 
KAPOLRES	K A P O L R E S 
KAPOLRI	K A P O L R I 
KAPOLSEK	K A P O L S E K 
KAPTEN	K A P T E N 
KARANGAN	K A R A NG A N 
KARAOKE	K A R A O K E 
KARAT	K A R A T 
KARENA	K A R E2 N A 
KARNO	K A R N O 
KARTASASMITA	K A R T A S A S M I T A 
KARTIKO	K A R T I K O 
KARTU	K A R T U 
KARUNG	K A R U NG 
KARYA	K A R Y A 
KARYANYA	K A R Y A NY A 
KARYAWAN	K A R Y A W A N 
KASAD	K A S A D 
KASDAM	K A S D A M 
KASET	K A S E T 
KASIEPO	K A S I E P O 
KASIH	K A S I H 
KAS	K A S 
KASUBAG	K A S U B A G 
KASUS	K A S U S 
KATAKAN	K A T A K A N 
KATA	K A T A 
KATANYA	K A T A NY A 
KATEDRAL	K A T E2 D R A L 
KATOLIK	K A T O L I K 
KAU	K AW 
KAUM	K A U M 
KAUS	K A U S 
KAVLING	K A F L I NG 
KAWASAN	K A W A S A N 
KAYA	K A Y A 
KAYU	K A Y U 
KAYU-KAYU	K A Y U K A Y U 
KEADAAN	K E2 K A D A K A N 
KEADAANNYA	K E2 K A D A K A N NY A 
KEADILAN	K E2 K A D I L A N 
KEAGUNGAN	K E A G U NG A N 
KEAMANAN	K E2 K A M A N A N 
KEBAKARAN	K E2 B A K A R A N 
KEBANGKITAN	K E2 B A NG K I T A N 
KEBEBASAN	K E2 B E B A S A N 
KEBENARAN	K E2 B E2 N A R A N 
KEBENCIAN	K E2 B E2 NY C I A N 
KEBERANGKATAN	K E2 B E2 R A NG K A T A N 
KEBERANIAN	K E2 B E2 R A N I A N 
KEBERATAN	K E2 B E2 R A T A N 
KEBERHASILANNYA	K E2 B E2 R H A S I L A N NY A 
KEBIJAKAN	K E2 B I J A K A N 
KEBOHONGAN	K E2 B O H O NG A N 
KEBUTUHAN	K E2 B U T U H A N 
KECAMATAN	K E2 C A M A T A N 
KECAM	K E2 C A M 
KECAP	K E C A P 
KECELAKAAN	K E2 C E2 L A K A K A N 
KECENDERUNGAN	K E2 C E2 N D E2 R U NG A N 
KECEWA	K E2 C E W A 
KECIL	K E2 C I L 
KECIL-KECILAN	K E2 C I L K E2 C I L A N 
KECOLONGAN	K E2 C O L O NG A N 
KECUALI	K E2 C U A L I 
KEDAERAHAN	K E2 D A E R A H A N 
KEDAI	K E2 D AY 
KEDATANGAN	K E2 D A T A NG A N 
KEDAULATAN	K E2 D A U L A T A N 
KEDIAMAN	K E2 D I A M A N 
KEDINGINAN	K E2 D I NG I N A N 
KEDUA	K E2 D U A 
KEDUBES	K E2 D U B E2 S 
KEDUDUKAN	K E2 D U D U K A N 
KEDUNGOMBO	K E2 D U NG O M B O 
KEDUTAAN	K E2 D U T A K A N 
KEDUTAANNYA	K E2 D U T A K A N NY A 
KEEFEKTIFAN	K E2 K E F E K T I F A N 
KEEMPAT	K E2 K E2 M P A T 
KEESOKAN	K E2 K E S O K A N 
KEHADIRAN	K E2 H A D I R A N 
KEHANCURAN	K E2 H A NY C U R A N 
KEHERANANNYA	K E2 H E R A N A N NY A 
KEHIDUPAN	K E2 H I D U P A N 
KEHILANGAN	K E2 H I L A NG A N 
KEHORMATAN	K E2 H O R M A T A N 
KEIKHLASAN	K E2 K I KH L A S A N 
KEJADIAN	K E2 J A D I A N 
KEJAGUNG	K E2 J A G U NG 
KEJAKSAAN	K E2 J A K S A K A N 
KEJORA	K E2 J O R A 
KEJUJURAN	K E2 J U J U R A N 
KEJU	K E J U 
KEKACAUAN	K E2 K A C A U A N 
KE	K E2 
KEKHAWATIRAN	K E2 KH A W A T I R A N 
KEKHILAFAN	K E2 KH I L A F A N 
KEKHUSUSAN	K E2 KH U S U S A N 
KEKUASAAN	K E2 K U A S A K A N 
KEKUATAN	K E2 K U A T A N 
KEKURANGAN	K E2 K U R A NG A N 
KELAPA	K E2 L A P A 
KELEBIHAN	K E2 L E2 B I H A N 
KELEWANG	K E2 L E2 W A NG 
KELILING	K E2 L I L I NG 
KELIMA	K E2 L I M A 
KELOMPOK	K E2 L O M P O K 
KELOMPOK-KELOMPOK	K E2 L O M P O K K E2 L O M P O K 
KELONGGARAN	K E2 L O NG G A R A N 
KELUARGA	K E2 L U A R G A 
KELUARGANYA	K E2 L U A R G A NY A 
KELUAR	K E2 L U A R 
KELUH	K E2 L U H 
KEMAJUAN	K E2 M A J U A N 
KEMAMPUAN	K E2 M A M P U A N 
KEMAMPUANNYA	K E2 M A M P U A N NY A 
KEMANUSIAAN	K E2 M A N U S I A K A N 
KEMARIN	K E2 M A R I N 
KEMAYORAN	K E2 M A Y O R A N 
KEMBALIAN	K E2 M B A L I A N 
KEMBALIANNYA	K E2 M B A L I A N NY A 
KEMBALIKAN	K E2 M B A L I K A N 
KEMBALI	K E2 M B A L I 
KEMENANGAN	K E2 M E2 N A NG A N 
KEMIRINGANNYA	K E2 M I R I NG A N NY A 
KEMUDIAN	K E2 M U D I A N 
KEMUNGKINAN	K E2 M U NG K I N A N 
KENAIKAN	K E2 N A I K A N 
KENAKAN	K E2 N A K A N 
KENDARAAN	K E2 N D A R A K A N 
KENDARAANNYA	K E2 N D A R A K A N NY A 
KENTAL	K E2 N T A L 
KENYATAAN	K E2 NY A T A K A N 
KEPADA	K E2 P A D A 
KEPALA	K E2 P A L A 
KEPALANYA	K E2 P A L A NY A 
KEPEGAWAIAN	K E2 P E2 G A W AY A N 
KEPEMILIKAN	K E2 P E2 M I L I K A N 
KEPEMIMPINANNYA	K E2 P E2 M I M P I N A N NY A 
KEPENTINGAN	K E2 P E2 N T I NG A N 
KEPINGIN	K E2 P I NG I N 
KEPMENNAKERTRANS	K E P M E2 N A K E2 R T R A N S 
KEPOLISIAN	K E2 P O L I S I A N 
KEPONAKANNYA	K E2 P O N A K A N NY A 
KEPPRES	K E2 P R E S 
KEPRIHATINAN	K E2 P R I H A T I N A N 
KEPULAUAN	K E2 P U L A U A N 
KEPUTUSAN	K E2 P U T U S A N 
KERABAT	K E2 R A B A T 
KERACUNAN	K E2 R A C U N A N 
KERAMIK	K E2 R A M I K 
KERANGKA	K E2 R A NG K A 
KERAN	K E2 R A N 
KERAP	K E2 R A P 
KERAS	K E2 R A S 
KERBAU	K E2 R B AW 
KERENTANAN	K E2 R E2 N T A N A N 
KERETA	K E2 R E T A 
KERINDUAN	K E2 R I N D U A N 
KERISAUAN	K E2 R I S A U A N 
KERITING	K E2 R I T I NG 
KERJA	K E2 R J A 
KERONCONG	K E2 R O NY C O NG 
KERUSAKAN	K E2 R U S A K A N 
KESALAHAN	K E2 S A L A H A N 
KESAN	K E2 S A N 
KESANNYA	K E2 S A N NY A 
KESEHATAN	K E2 S E H A T A N 
KESELURUHAN	K E2 S E2 L U R U H A N 
KESEMPATAN	K E2 S E2 M P A T A N 
KESENIAN	K E2 S E2 N I A N 
KESEPAKATAN	K E2 S E2 P A K A T A N 
KESIAPAN	K E2 S I A P A N 
KESIBUKAN	K E2 S I B U K A N 
KESIMPULAN	K E2 S I M P U L A N 
KESOWO	K E2 S O W O 
KESRA	K E2 S R A 
KESULITAN	K E2 S U L I T A N 
KETELEDORAN	K E2 T E2 L E D O R A N 
KETENTUAN	K E2 T E2 N T U A N 
KETERAMPILAN	K E2 T E2 R A M P I L A N 
KETERANGAN	K E2 T E2 R A NG A N 
KETETAPAN	K E2 T E2 T A P A N 
KETIDAKPASTIAN	K E2 T I D A K P A S T I A N 
KETIGA	K E2 T I G A 
KETIKA	K E2 T I K A 
KETIMBANG	K E2 T I M B A NG 
KETOPRAK	K E2 T O P R A K 
KETUA	K E2 T U A 
KETUJUH	K E2 T U J U H 
KETUPAT	K E2 T U P A T 
KEUANGAN	K E2 K U A NG A N 
KEUNGGULAN	K E2 K U NG G U L A N 
KEUNTUNGAN	K E2 K U N T U NG A N 
KEWELL	K E W E L 
KEWENANGAN	K E2 W E2 N A NG A N 
KEYAKINAN	K E2 Y A K I N A N 
KEYAKINANNYA	K E2 Y A K I N A N NY A 
KEZALIMAN	K E2 Z A L I M A N 
KHADIJAH	KH O D I J A H 
KHAIRUL	KH O I R U L 
KHALAYAK	KH A L A Y A K 
KHALAYAKNYA	KH A L A Y A K NY A 
KHALID	KH O L I D 
KHALIL	KH O L I L 
KHARISMA	KH A R I S M A 
KHASANAH	KH A S A N A H 
KHAS	KH A S 
KHAWATIR	KH A W A T I R 
KHAYAL	KH A Y A L 
KHAZANAH	KH A Z A N A H 
KHIANATI	KH I A N A T I 
KHIDMAT	KH I D M A T 
KHILAF	KH I L A F 
KHIROM	KH I R O M 
KHITANAN	KH I T A N A N 
KHOFIFAH	KH O F I F A H 
KHOLID	KH O L I D 
KHOLIK	KH O L I K 
KHOTIB	KH O T I B 
KHRISNA	KH R I S N A 
KHRISNINA	KH R I S N I N A 
KHUSUS	KH U S U S 
KHUSUSNYA	KH U S U S NY A 
KHUSYUK	KH U SY U K 
KIAI	K I A I 
KIAN	K I A N 
KIAT	K I A T 
KIDUL	K I D U L 
KIEMAS	K I E M A S 
KI	K I 
KILANG	K I L A NG 
KIMIA	K I M I A 
KINERJA	K I N E2 R J A 
KINI	K I N I 
KIOS	K I O S 
KIRA	K I R A 
KIRA-KIRA	K I R A K I R A 
KIRBIANTORO	K I R B I A N T O R O 
KIRI	K I R I 
KIRIMKAN	K I R I M K A N 
KIRIM	K I R I M 
KIRINYA	K I R I NY A 
KITA	K I T A 
KLAB	K L A B 
KLAIM-KLAIM	K L EY M K L EY M 
KLAIM	K L EY M 
KLARIFIKASI	K L A R I F I K A S I 
KLASIK	K L A S I K 
KLIENNYA	K L I E N NY A 
KLIRING	K L I R I NG 
KLOSET	K L O S E T 
KLOTER	K L O T E2 R 
KLUB	K L U B 
KLUB-KLUB	K L U B K L U B 
KLUBNYA	K L U B NY A 
KOBOI	K O B OY 
KOCAR-KACIR	K O C A R K A C I R 
KODAM	K O D A M 
KODE	K O D E2 
KODIM	K O D I M 
KODYA	K O D Y A 
KOESHADIANTO	K U S H A D I A N T O 
KOGNITIF	K O G N I T I F 
KOIZUMI	K O I Z U M I 
KOK	K O K 
KOKO	K O K O 
KOKTAIL	K O K T A I L 
KOLAM	K O L A M 
KOLEKTIF	K O L E K T I F 
KOLOM	K O L O M 
KOMA	K O M A 
KOMANDAN	K O M A N D A N 
KOMANDO	K O M A N D O 
KOMAT-KAMIT	K O M A T K A M I T 
KOMEDI	K O M E D I 
KOMERSIAL	K O M E R S I A L 
KOMISARIS	K O M I S A R I S 
KOMISI	K O M I S I 
KOMITE	K O M I T E2 
KOMITMEN	K O M I T M E2 N 
KOMITMENNYA	K O M I T M E2 N NY A 
KOMNAS	K O M N A S 
KOMODITAS	K O M O D I T A S 
KOMPAS	K O M P A S 
KOMPETEN	K O M P E2 T E N 
KOMPETISI	K O M P E2 T I S I 
KOMPLAIN	K O M P L EY N 
KOMPLEKS	K O M P L E K S 
KOMPLEKSNYA	K O M P L E K S NY A 
KOMPREHENSIF	K O M P R E H E N S I F 
KOMPUTER	K O M P U T E2 R 
KOMSELINDO	K O M S E L I N D O 
KOMUNIKE	K O M U N I K E2 
KONDISI	K O N D I S I 
KONDISINYA	K O N D I S I NY A 
KONFERENSI	K O N F E2 R E N S I 
KONFLIK	K O N F L I K 
KONGHUCU	K O NG H U C U 
KONGKOW-KONGKOW	K O NG K O W K O NG K O W 
KONGLOMERAT	K O NG L O M E2 R A T 
KONSENSUS	K O N S E N S U S 
KONSEP	K O N S E P 
KONSEPNYA	K O N S E P NY A 
KONSER	K O N S E R 
KONSERVASI	K O N S E R F A S I 
KONSPIRASI	K O N S P I R A S I 
KONSTITUSI	K O N S T I T U S I 
KONSUMSI	K O N S U M S I 
KONTAINERNYA	K O N T EY N E2 R NY A 
KONTINYU	K O N T I NY U 
KONTRIBUSI	K O N T R I B U S I 
KONTROL	K O N T R O L 
KONVERSI	K O N F E R S I 
KONVOI	K O N F OY 
KOORDINATOR	K O K O R D I N A T O R 
KOPERASI	K O P E2 R A S I 
KOPI	K O P I 
KOPILOT	K O P I L O T 
KOPOR	K O P O R 
KORAN	K O R A N 
KORBAN	K O R B A N 
KOREA	K O R E A 
KOREM	K O R E M 
KORPS	K O R P S 
KORSLETING	K O R S L E T I NG 
KORUPTOR	K O R U P T O R 
KOSASIH	K O S A S I H 
KOSONG	K O S O NG 
KOSOVO	K O S O F O 
KOSTRAD	K O S T R A D 
KOTAK	K O T A K 
KOTA	K O T A 
KOTANYA	K O T A NY A 
KRAM	K R A M 
KRAYAN	K R A Y A N 
KREATIF	K R E A T I F 
KREDIBELNYA	K R E D I B E2 L NY A 
KREDIT	K R E D I T 
KRIMINAL	K R I M I N A L 
KRIMINOLOG	K R I M I N O L O G 
KRISIS	K R I S I S 
KRISMON	K R I S M O N 
KRISNA	K R I S N A 
KRISTIANI	K R I S T I A N I 
KRISTUS	K R I S T U S 
KRITERIA	K R I T E R I A 
KRITIKAN	K R I T I K A N 
KRITIK	K R I T I K 
KRITIKUS	K R I T I K U S 
KRITIS	K R I T I S 
KROMOSOM	K R O M O S O M 
KRONIK	K R O N I K 
KRONINYA	K R O N I NY A 
KRUENG	K R U E NG 
KRU	K R U 
KUALITAS	K U A L I T A S 
KUALITASNYA	K U A L I T A S NY A 
KUASA	K U A S A 
KUAT	K U A T 
KUBU	K U B U 
KUBUR	K U B U R 
KUDA	K U D A 
KUE	K U E 
KUITANSI	K U I T A N S I 
KUITANSINYA	K U I T A N S I NY A 
KUKU	K U K U 
KULI	K U L I 
KULIT	K U L I T 
KULONPROGO	K U L O N P R O G O 
KUMAN	K U M A N 
KUMISNYA	K U M I S NY A 
KUNCI	K U NY C I 
KUNING	K U N I NG 
KUNJUNGAN	K U NY J U NG A N 
KUNJUNGANNYA	K U NY J U NG A N NY A 
KUNJUNGI	K U NY J U NG I 
KURANG	K U R A NG 
KURNIAWAN	K U R N I A W A N 
KURSI	K U R S I 
KURS	K U R S 
KURSNYA	K U R S NY A 
KUSBINI	K U S B I N I 
KUTA	K U T A 
KUYUP	K U Y U P 
KWIK	K W I K 
KYAI	K Y A I 
LABEL	L A B E L 
LABORATORIUM	L A B O R A T O R I U M 
LACI	L A C I 
LADA	L A D A 
LAGI	L A G I 
LAGU	L A G U 
LAGU-LAGU	L A G U L A G U 
LAHAN	L A H A N 
LAHIR	L A H I R 
LAHIRLAH	L A H I R L A H 
LAIN	L A I N 
LAINNYA	L A I N NY A 
LAKI-LAKI	L A K I L A K I 
LAKSAMANA	L A K S A M A N A 
LAKUKAN	L A K U K A N 
LA	L A 
LALUI	L A L U I 
LALU	L A L U 
LAMA	L A M A 
LAMBAIAN	L A M B AY A N 
LAMBAN	L A M B A N 
LAMONGAN	L A M O NG A N 
LAMPAU	L A M P AW 
LAMPU	L A M P U 
LAMPUNG	L A M P U NG 
LANDAI-LANDAI	L A N D AY L A N D AY 
LANDAI	L A N D AY 
LANGGAM	L A NG G A M 
LANGIT	L A NG I T 
LANGKAH	L A NG K A H 
LANGKA	L A NG K A 
LANGSUNG	L A NG S U NG 
LANJUT	L A NY J U T 
LANTAI	L A N T AY 
LANTAS	L A N T A S 
LANTIK	L A N T I K 
LANUD	L A N U D 
LAODE	L A K O D E 
LAOS	L A O S 
LAPANGAN	L A P A NG A N 
LAPORAN	L A P O R A N 
LAPORANNYA	L A P O R A N NY A 
LARANG	L A R A NG 
LARI	L A R I 
LARIS	L A R I S 
LASKAR	L A S K A R 
LAUT	L A U T 
LAWAN	L A W A N 
LAYAK	L A Y A K 
LAYANAN	L A Y A N A N 
LAYANANNYA	L A Y A N A N NY A 
LAYAR	L A Y A R 
LAZIM	L A Z I M 
LAZIO	L A Z I O 
LEBARAN	L E2 B A R A N 
LEBDORINI	L E B D O R I N I 
LEBIH	L E2 B I H 
LEDAKAN	L E2 D A K A N 
LEGAL	L E G A L 
LEGENDA	L E2 G E N D A 
LEGIUN	L E G I U N 
LEGOWO	L E2 G O W O 
LEHER	L E H E R 
LEKAT	L E2 K A T 
LELAH	L E2 L A H 
LELAKI	L E2 L A K I 
LELUASA	L E2 L U A S A 
LEMAH	L E2 M A H 
LEMBAGA	L E2 M B A G A 
LEMBAH	L E2 M B A H 
LEMBUR	L E2 M B U R 
LEMHANNAS	L E M H A N A S 
LEMPARAN	L E M P A R A N 
LEMPAR-LEMPARAN	L E M P A R L E M P A R A N 
LEMPENGAN	L E M P E NG A N 
LEMPENG	L E M P E NG 
LENGANG	L E2 NG A NG 
LENGKAP	L E2 NG K A P 
LEO	L E O 
LEONARDO	L E O N A R D O 
LERENG	L E R E NG 
LERENGNYA	L E R E NG NY A 
LESTARI	L E2 S T A R I 
LESU	L E2 S U 
LETAKNYA	L E2 T A K NY A 
LETJEN	L E T J E N 
LETKOL	L E T K O L 
LEWAT	L E W A T 
LEZAT	L E2 Z A T 
LHA	H L A 
LIAR	L I A R 
LIBERO	L I B E R O 
LIBURAN	L I B U R A N 
LIE	L I 
LIGITAN	L I G I T A N 
LIHAI	L I H AY 
LIHAT	L I H A T 
LIHATNYA	L I H A T NY A 
LIKUID	L I K U I D 
LILIEK	L I L I K 
LIMA	L I M A 
LIMBAH	L I M B A H 
LIMPAHAN	L I M P A H A N 
LINCOLN	L I NG K E2 N 
LINGKUNGAN	L I NG K U NG A N 
LINGKUP	L I NG K U P 
LINTAS	L I N T A S 
LIPPO	L I P P O 
LISTRIK	L I S T R I K 
LOBI	L O B I 
LOGAT	L O G A T 
LOGIKA	L O G I K A 
LOGISTIK	L O G I S T I K 
LOKAL	L O K A L 
LOKASI	L O K A S I 
LOKET-LOKET	L O K E T L O K E T 
LOLOS	L O L O S 
LOMBA	L O M B A 
LOMBOK	L O M B O K 
LONDON	L O N D O N 
LOROSAE	L O R O S A E 
LOWONG	L O W O NG 
LUAR	L U A R 
LUAS	L U A S 
LUBANG	L U B A NG 
LUBULINGGAU	L U B U L I NG G AW 
LUCU	L U C U 
LULUS	L U L U S 
LUMRAH	L U M R A H 
LUNGLAI	L U NG L AY 
LUPA	L U P A 
LUTFI	L U T F I 
LUWUK	L U W U K 
MAAFKAN	M A K A F K A N 
MAAF	M A K A F 
MAARIF	M A K A R I F 
MABES	M A B E S 
MACAM	M A C A M 
MACET	M A C E2 T 
MACHFUDZ	M A KH F U D Z 
MADJID	M A J I D 
MAFTUH	M A F T U H 
MAGHRIB	M A G R I B 
MAHADI	M A H A D I 
MAHAL	M A H A L 
MAHARANI	M A H A R A N I 
MAHASISWA	M A H A S I S W A 
MAHATHIR	M A H A T I R 
MAHENDRA	M A H E N D R A 
MAHFUD	M A H F U D 
MAIN	M A I N 
MAJALAH	M A J A L A H 
MAJELIS	M A J E2 L I S 
MAJID	M A J I D 
MAKA	M A K A 
MAKANAN	M A K A N A N 
MAKAN	M A K A N 
MAKANYA	M A K A NY A 
MAKARIM	M A K A R I M 
MAKASSAR	M A K A S A R 
MAKHFUD	M A KH F U D 
MAKHLUK	M A KH L U K 
MAKLUMAT	M A K L U M A T 
MAKMUR	M A K M U R 
MAKRUF	M A K R U F 
MAKSUD	M A K S U D 
MAKTAB	M A K T A B 
MALAH	M A L A H 
MALAIHOLLO	M A L A I H O L O 
MALAM	M A L A M 
MALAYSIA	M A L AY S I A 
MAL	M O L 
MALUKU	M A L U K U 
MAMPANG	M A M P A NG 
MAMPIR	M A M P I R 
MAMPU	M A M P U 
MANAGEMEN	M E N E J E2 M E2 N 
MANAJER	M E N E J E2 R 
MANAKAH	M A N A K A H 
MANAKALA	M A N A K A L A 
MANA	M A N A 
MANDAU	M A N D AW 
MANDEG	M A N D E2 G 
MANDEK	M A N D E2 K 
MANDI	M A N D I 
MANHATTAN	M A N H A T A N 
MANTAN	M A N T A N 
MANTEB	M A N T E2 B 
MANUEL	M A N U E L 
MANUSIA	M A N U S I A 
MANUVER-MANUVER	M A N U F E2 R M A N U F E2 R 
MAPOLRES	M A P O L R E S 
MARET	M A R E2 T 
MARFUAH	M A R F U K A H 
MARGA	M A R G A 
MARIA	M A R I A 
MARI	M A R I 
MARIO	M A R I O 
MARKAS	M A R K A S 
MARLEY	M A R L EY 
MARS	M A R S 
MARTINI	M A R T I N I 
MARTINUS	M A R T I N U S 
MARTY	M A R T I 
MARZUKI	M A R Z U K I 
MASAKAN	M A S A K A N 
MASAKANNYA	M A S A K A N NY A 
MASAK	M A S A K 
MASALAH	M A S A L A H 
MASA	M A S A 
MASHUDI	M A S H U D I 
MASIH	M A S I H 
MASING-MASING	M A S I NG M A S I NG 
MASJID	M A S J I D 
MASSAL	M A S S A L 
MASSA	M A S S A 
MASTERCARD	M A S T E2 R K A R D 
MASUKAN	M A S U K A N 
MASUK	M A S U K 
MASUKNYA	M A S U K NY A 
MASYARAKAT	M A SY A R A K A T 
MASYUMI	M A SY U M I 
MATA	M A T A 
MATANG	M A T A NG 
MATERAI	M A T E R AY 
MATI	M A T I 
MATINEE	M A T I N EY 
MATORI	M A T O R I 
MAUKAH	M A U K A H 
MAU	M A U 
MAUPUN	M A U P U N 
MAWAR	M A W A R 
MAYA	M A Y A 
MAYJEND	M AY J E N 
MAYJEN	M AY J E N 
MAYOR	M A Y O R 
MAZHAB	M A Z A B 
MBAH	M B A H 
MBAK	M B A K 
MEDALI	M E2 D A L I 
MEDAN	M E D A N 
MEDIA	M E D I A 
MEDIS	M E D I S 
MEGA	M E G A 
MEGAWATI-HAMZAH	M E G A W A T I H A M Z A H 
MEGAWATI	M E G A W A T I 
MEI	M E I 
MEJA	M E J A 
MEJELIS	M E2 J E2 L I S 
MEKANISME	M E K A N I S M E2 
MEKKAH	M E2 K K A H 
MELAJU	M E2 L A J U 
MELAKSANAKAN	M E2 L A K S A N A K A N 
MELAKUKAN	M E2 L A K U K A N 
MELAKUKANNYA	M E2 L A K U K A N NY A 
MELALUI	M E2 L A L U I 
MELAMBAI-LAMBAIKAN	M E2 L A M B AY L A M B AY K A N 
MELAMBAI	M E2 L A M B AY 
MELAMPAUI	M E2 L A M P AW I 
MELANGGAR	M E2 L A NG G A R 
MELANJUTKAN	M E2 L A NY J U T K A N 
MELANTIK	M E2 L A N T I K 
MELATA	M E2 L A T A 
MELAYANI	M E2 L A Y A N I 
MELEBIHI	M E2 L E2 B I H I 
MELEDAK	M E2 L E2 D A K 
MELEJIT	M E2 L E2 J I T 
MELEMAH	M E2 L E2 M A H 
MELEMAHNYA	M E2 L E2 M A H NY A 
MELEMPAR	M E2 L E M P A R 
MELEPASKAN	M E2 L E2 P A S K A N 
MELERAI	M E2 L E2 R AY 
MELETAKKAN	M E2 L E2 T A K K A N 
MELEWATI	M E2 L E W A T I 
MELEWATINYA	M E2 L E W A T I NY A 
MELIHAT	M E2 L I H A T 
MELIPATGANDAKAN	M E2 L I P A T G A N D A K A N 
MELIRIK	M E2 L I R I K 
MELONJAK	M E2 L O NY J A K 
MELONJAKNYA	M E2 L O NY J A K NY A 
MELONTARKAN	M E2 L O N T A R K A N 
MELUAP	M E2 L U A P 
MELUAPNYA	M E2 L U A P NY A 
MEMADAI	M E2 M A D A I 
MEMAHAMINYA	M E2 M A H A M I NY A 
MEMAKAI	M E2 M A K AY 
MEMAKLUMI	M E2 M A L U M I 
MEMANASKAN	M E2 M A N A S K A N 
MEMANCING	M E2 M A NY C I NG 
MEMANDANG	M E2 M A N D A NG 
MEMANFAATKAN	M E2 M A N F A K A T K A N 
MEMANGGILKAN	M E2 M A NG G I L K A N 
MEMANGGIL	M E2 M A NG G I L 
MEMANGKU	M E2 M A NG K U 
MEMANG	M E M A NG 
MEMASARKAN	M E2 M A S A R K A N 
MEMASTIKAN	M E2 M A S T I K A N 
MEMATAHKAN	M E2 M A T A H K A N 
MEMBALIKKAN	M E2 M B A L I K K A N 
MEMBANGKITKAN	M E2 M B A NG K I T K A N 
MEMBANGUN	M E2 M B A NG U N 
MEMBANJIRI	M E2 M B A NY J I R I 
MEMBANTAH	M E2 M B A N T A H 
MEMBANTU	M E2 M B A N T U 
MEMBARIKADE	M E2 M B A R I K A D E2 
MEMBATASI	M E2 M B A T A S I 
MEMBAWA	M E2 M B A W A 
MEMBAYAR	M E2 M B A Y A R 
MEMBAYARNYA	M E2 M B A Y A R NY A 
MEMBEBANKAN	M E2 M B E2 B A N K A N 
MEMBEBASKAN	M E2 M B E B A S K A N 
MEMBELA	M E2 M B E L A 
MEMBELI	M E2 M B E2 L I 
MEMBELINYA	M E2 M B E2 L I NY A 
MEMBENARKAN	M E2 M B E2 N A R K A N 
MEMBENTUK	M E2 M B E2 N T U K 
MEMBERDAYAKAN	M E2 M B E2 R D A Y A K A N 
MEMBERIKAN	M E2 M B E2 R I K A N 
MEMBERI	M E2 M B E2 R I 
MEMBERITAHUKAN	M E2 M B E2 R I T A U K A N 
MEMBERITAHU	M E2 M B E2 R I T A U 
MEMBERLAKUKAN	M E2 M B E2 R L A K U K A N 
MEMBEZUK	M E2 M B E2 Z U K 
MEMBICARAKANNYA	M E2 M B I C A R A K A N NY A 
MEMBOHONGI	M E2 M B O H O NG I 
MEMBUANG	M E2 M B U A NG 
MEMBUAT	M E2 M B U A T 
MEMBUBARKAN	M E2 M B U B A R K A N 
MEMBUJUK	M E2 M B U J U K 
MEMBUKA	M E2 M B U K A 
MEMBUNUH	M E2 M B U N U H 
MEMBURAI	M E2 M B U R AY 
MEMBURUK	M E2 M B U R U K 
MEMBUTUHKAN	M E2 M B U T U H K A N 
MEMECAHKAN	M E2 M E2 C A H K A N 
MEMEGANG	M E2 M E G A NG 
MEMENEJ	M E2 M E N E J 
MEMENUHI	M E2 M E2 N U H I 
MEMEPET	M E2 M E P E T 
MEMERIKSA	M E2 M E2 R I K S A 
MEMERIKSANYA	M E2 M E2 R I K S A NY A 
MEMERINTAHKAN	M E2 M E2 R I N T A H K A N 
MEMERINTAH	M E2 M E2 R I N T A H 
MEMESANKAN	M E2 M E2 S A N K A N 
MEMESAN	M E2 M E2 S A N 
MEMICU	M E2 M I C U 
MEMIKIRKAN	M E2 M I K I R K A N 
MEMILIKI	M E2 M I L I K I 
MEMIMPIN	M E2 M I M P I N 
MEMINJAMKAN	M E2 M I NY J A M K A N 
MEMINJAM	M E2 M I NY J A M 
MEMINTA	M E2 M I N T A 
MEMO	M E M O 
MEMPELAJARI	M E2 M P E2 L A J A R I 
MEMPENGARUHI	M E2 M P E2 NG A R U H I 
MEMPERCEPAT	M E2 M P E2 R C E2 P A T 
MEMPERINDAG	M E2 M P E2 R I N D A G 
MEMPERINGATI	M E2 M P E2 R I NG A T I 
MEMPERKENALKAN	M E2 M P E2 R K E2 N A L K A N 
MEMPEROLEH	M E2 M P E2 R O L E H 
MEMPERSIAPKAN	M E2 M P E2 R S I A P K A N 
MEMPERTAHANKAN	M E2 M P E2 R T A H A N K A N 
MEMPERTANGGUNGJAWABKAN	M E2 M P E2 R T A NG G U NG J A W A B K A N 
MEMPORAKPORANDAKAN	M E2 M P O R A K P O R A N D A K A N 
MEMPUNYAI	M E2 M P U NY A I 
MEMUJI	M E2 M U J I 
MEMUNCULKANNYA	M E2 M U NY C U L K A N NY A 
MEMUNGKIRI	M E2 M U NG K I R I 
MEMUTAR	M E2 M U T A R 
MEMUTUSKAN	M E2 M U T U S K A N 
MENABURKAN	M E2 N A B U R K A N 
MENAFIKAN	M E2 N A F I K A N 
MENAIKKAN	M E2 N A I K K A N 
MENAMBAHKAN	M E2 N A M B A H K A N 
MENAMBAH	M E2 N A M B A H 
MENAMPIK	M E2 N A M P I K 
MENAMPUNG	M E2 N A M P U NG 
MENANDATANGANI	M E2 N A N D A T A NG A N I 
MENANGANI	M E2 N A NG A N I 
MENANGGAPI	M E2 N A NG G A P I 
MENANGGAPINYA	M E2 N A NG G A P I NY A 
MENANGKAL	M E2 N A NG K A L 
MENANGKAP	M E2 N A NG K A P 
MENARIK	M E2 N A R I K 
MENATA	M E2 N A T A 
MENATAP	M E2 N A T A P 
MENCABIK-CABIK	M E2 NY C A B I K C A B I K 
MENCAPAI	M E2 NY C A P AY 
MENCARI	M E2 NY C A R I 
MENCECAR	M E2 NY C E2 C A R 
MENCEGAH	M E2 NY C E2 G A H 
MENCEGAHNYA	M E2 NY C E2 G A H NY A 
MENCEMARKAN	M E2 NY C E2 M A R K A N 
MENCERITAKAN	M E2 NY C E2 R I T A K A N 
MENCERMINKAN	M E2 NY C E2 R M I N K A N 
MENCIPTAKAN	M E2 NY C I P T A K A N 
MENCIPTA	M E2 NY C I P T A 
MENCIUT	M E2 NY C I U T 
MENCLA-MENCLE	M E2 NY C L A M E2 NY C L E 
MENCOBANYA	M E2 NY C O B A NY A 
MENCORENG	M E2 NY C O R E NG 
MENCRET	M E NY C R E T 
MENCUAT	M E2 NY C U A T 
MENCURIGAI	M E2 NY C U R I G A I 
MENDAFTARKAN	M E2 N D A F T A R K A N 
MENDAGRI	M E2 N D A G R I 
MENDAPATKAN	M E2 N D A P A T K A N 
MENDAPATKANNYA	M E2 N D A P A T K A N NY A 
MENDAPAT	M E2 N D A P A T 
MENDARAT	M E2 N D A R A T 
MENDATANGI	M E2 N D A T A NG I 
MENDATANGKAN	M E2 N D A T A NG K A N 
MENDATANG	M E2 N D A T A NG 
MENDEKATI	M E2 N D E2 K A T I 
MENDENGARKAN	M E2 N D E2 NG A R K A N 
MENDENGAR	M E2 N D E2 NG A R 
MENDENGARNYA	M E2 N D E2 NG A R NY A 
MENDESAK	M E2 N D E2 S A K 
MENDETEKSI	M E2 N D E2 T E K S I 
MENDIKBUD	M E2 N D I K B U D 
MENDIKNAS	M E2 N D I K N A S 
MENDOZA	M E N D O Z A 
MENDUGA	M E2 N D U G A 
MENDUKUNG	M E2 N D U K U NG 
MENEBANG	M E2 N E2 B A NG 
MENEGAKKAN	M E2 N E2 G A K K A N 
MENEGASKAN	M E2 N E2 G A S K A N 
MENEG	M E N E G 
MENEKANKAN	M E2 N E2 K A N K A N 
MENELEPON	M E2 N E2 L E2 P O N 
MENELEPONNYA	M E2 N E2 L E2 P O N NY A 
MENELUSURI	M E2 N E2 L U S U R I 
MENEMUI	M E2 N E2 M U I 
MENEMUKAN	M E2 N E2 M U K A N 
MENENGAH	M E2 N E2 NG A H 
MENENGARAI	M E2 N E2 NG A R AY 
MENENGOK	M E2 N E NG O K 
MENENTUKAN	M E2 N E2 N T U K A N 
MENEPIS	M E2 N E2 P I S 
MENERAPKAN	M E2 N E2 R A P K A N 
MENERIMA	M E2 N E2 R I M A 
MENETAPKAN	M E2 N E2 T A P K A N 
MENEWASKAN	M E2 N E W A S K A N 
MENGABAIKAN	M E2 NG A B AY K A N 
MENGACAUKAN	M E2 NG A C AW K A N 
MENGACU	M E2 NG A C U 
MENGACUNG-ACUNGKAN	M E2 NG A C U NG A C U NG K A N 
MENGADAKAN	M E2 NG A D A K A N 
MENGADILI	M E2 NG A D I L I 
MENGAJUKAN	M E2 NG A J U K A N 
MENGAKUI	M E2 NG A K U I 
MENGAKU	M E2 NG A K U 
MENGALAMI	M E2 NG A L A M I 
MENGALIR	M E2 NG A L I R 
MENGAMANKAN	M E2 NG A M A N K A N 
MENGAMBILKAN	M E2 NG A M B I L K A N 
MENGAMBIL	M E2 NG A M B I L 
MENGANDUNG	M E2 NG A N D U NG 
MENGANTAR	M E2 NG A N T A R 
MENGANTRI	M E2 NG A N T R I 
MENGANUT	M E2 NG A N U T 
MENGAPA	M E2 NG A P A 
MENGATAKAN	M E2 NG A T A K A N 
MENGATASI	M E2 NG A T A S I 
MENGAWINI	M E2 NG A W I N I 
MENGECAT	M E2 NG E2 C A T 
MENGECEK	M E2 NG E2 C E K 
MENGECEKNYA	M E2 NG E2 C E K NY A 
MENGEDEPANKAN	M E2 NG E2 D E2 P A N K A N 
MENGEJAR	M E2 NG E2 J A R 
MENGEKANG	M E2 NG E2 K A NG 
MENGEKSPRESIKAN	M E2 NG E K S P R E S I K A N 
MENGELAK	M E2 NG E L A K 
MENGELOLA	M E2 NG E2 L O L A 
MENGELUARKAN	M E2 NG E2 L U A R K A N 
MENGELU-ELUKAN	M E2 NG E2 L U E2 L U K A N 
MENGELUH	M E2 NG E2 L U H 
MENGEMBALIKAN	M E2 NG E2 M B A L I K A N 
MENGEMUDI	M E2 NG E2 M U D I 
MENGEMUKAKAN	M E2 NG E2 M U K A K A N 
MENGENAI	M E2 NG E2 N A I 
MENGENAKAN	M E2 NG E2 N A K A N 
MENGENAL	M E2 NG E2 N A L 
MENGENDARAI	M E2 NG E2 N D A R A I 
MENGENYAM	M E2 NG E2 NY A M 
MENGERIKAN	M E2 NG E2 R I K A N 
MENGESANKAN	M E2 NG E2 S A NG A N 
MENGETAHUI	M E2 NG E2 T A U I 
MENGETUK-NGETUK	M E2 NG E2 T U K NG E2 T U K 
MENGEVAKUASIKAN	M E2 NG E F A K U A S I K A N 
MENGEVAKUASI	M E2 NG E F A K U A S I 
MENGGANDENG	M E2 NG G A N D E NG 
MENGGANGGU	M E2 NG G A NG G U 
MENGGANTI	M E2 NG G A N T I 
MENGGARAP	M E2 NG G A R A P 
MENGGEDOR	M E2 NG G E2 D O R 
MENGGELAR	M E2 NG G E2 L A R 
MENGGELEMBUNG	M E2 NG G E2 L E2 M B U NG 
MENGGENCET	M E2 NG G E2 NY C E T 
MENGGENDONG	M E2 NG G E N D O NG 
MENGGIGIL	M E NG G I G I L 
MENGGUGAT	M E2 NG G U G A T 
MENGGULUNG	M E2 NG G U L U NG 
MENGGUNAKAN	M E2 NG G U N A K A N 
MENGGUNAKANNYA	M E2 NG G U N A K A N NY A 
MENGGUYUR	M E2 NG G U Y U R 
MENGHABISKAN	M E2 NG H A B I S K A N 
MENGHADAPI	M E2 NG H A D A P I 
MENGHADIRI	M E2 NG H A D I R I 
MENGHADIRKAN	M E2 NG H A D I R K A N 
MENGHALAU	M E2 NG H A L A U 
MENGHAMBAT	M E2 NG H A M B A T 
MENGHARAPKAN	M E2 NG H A R A P K A N 
MENGHASILKAN	M E2 NG H A S I L K A N 
MENGHIASI	M E2 NG H I A S I 
MENGHILANGKAN	M E2 NG H I L A NG K A N 
MENGHILANG	M E2 NG H I L A NG 
MENGHINDARI	M E2 NG H I N D A R I 
MENGHIRAUKAN	M E2 NG H I R A U K A N 
MENGHORMATI	M E2 NG H O R M A T I 
MENGHUBUNGI	M E2 NG H U B U NG I 
MENGHUKUM	M E2 NG H U K U M 
MENGIKUTI	M E2 NG I K U T I 
MENGILHAMI	M E2 NG I L H A M I 
MENGIMPOR	M E2 NG I M P O R 
MENGINGATKAN	M E2 NG I NG A T K A N 
MENGINJAK-INJAK	M E2 NG I NY J A K I NY J A K 
MENGINTAI	M E2 NG I N T AY 
MENGINTERVENSINYA	M E2 NG I N T E2 R F E N S I NY A 
MENGIPAS-NGIPASI	M E2 NG I P A S NG I P A S I 
MENGIRIMKAN	M E2 NG I R I M K A N 
MENGIRIM	M E2 NG I R I M 
MENGISI	M E2 NG I S I 
MENGISYARATKAN	M E2 NG I SY A R A T K A N 
MENGIZINKAN	M E2 NG I Z I NG A N 
MENGKLAIM	M E2 NG K L AY M 
MENGKLONING	M E2 NG K L O N I NG 
MENGKONSUMSI	M E2 NG K O N S U M S I 
MENGKRITIK	M E2 NG K R I T I K 
MENGOCEH	M E2 NG O C E H 
MENGOJEK	M E2 NG O J E K 
MENGONSUMSI	M E2 NG O N S U M S I 
MENGOREK	M E2 NG O R E K 
MENGOREK-NGOREK	M E2 NG O R E K NG O R E K 
MENGUASAI	M E2 NG U A S A I 
MENGUAT	M E2 NG U A T 
MENGUATNYA	M E2 NG U A T NY A 
MENGUBAH	M E2 NG U B A H 
MENGUBEK-NGUBEK	M E2 NG U B E2 K NG U B E2 K 
MENGUCAP	M E2 NG U C A P 
MENGULANGI	M E2 NG U L A NG I 
MENGULUR-NGULUR	M E2 NG U L U R NG U L U R 
MENGUNDANG	M E2 NG U N D A NG 
MENGUNGKAPKAN	M E2 NG U NG K A P K A N 
MENGUNGKAP	M E2 NG U NG K A P 
MENGURANGI	M E2 NG U R A NG I 
MENGURUSI	M E2 NG U R U S I 
MENGUTARAKAN	M E2 NG U T A R A K A N 
MENGUTIP	M E2 NG U T I P 
MENGUTUK	M E2 NG U T U K 
MENHUB	M E N H U B 
MENHUTBUN	M E N H U T B U N 
MENIKAH	M E2 N I K A H 
MENILAI	M E2 N I L AY 
MENIMBULKAN	M E2 N I M B U L K A N 
MENINDAK	M E2 N I N D A K 
MENINDIHNYA	M E2 N I N D I H NY A 
MENINGGALKAN	M E2 N I NG G A L K A N 
MENINGGAL	M E2 N I NG G A L 
MENINGGALNYA	M E2 N I NG G A L NY A 
MENINGKATKAN	M E2 N I NG K A T K A N 
MENINGKAT	M E2 N I NG K A T 
MENINGKATNYA	M E2 N I NG K A T NY A 
MENINJAU	M E2 N I NY J AW 
MENIT	M E2 N I T 
MENJABAT	M E2 NY J A B A T 
MENJADI	M E2 NY J A D I 
MENJAGA	M E2 NY J A G A 
MENJALANI	M E2 NY J A L A N I 
MENJALANKAN	M E2 NY J A L A N K A N 
MENJAMBRET	M E2 NY J A M B R E2 T 
MENJAMIN	M E2 NY J A M I N 
MENJARAH	M E2 NY J A R A H 
MENJAWAB	M E2 NY J A W A B 
MENJAWABNYA	M E2 NY J A W A B NY A 
MENJELANG	M E2 NY J E2 L A NG 
MENJELASKAN	M E2 NY J E2 L A S K A N 
MENJENGUK	M E2 NY J E2 NG U K 
MENJUAL	M E2 NY J U A L 
MENKEU	M E N K E2 U 
MENKO	M E N K O 
MENKOP	M E N K O P 
MENLU	M E2 N L U 
MENNEG	M E N E2 G 
MENOLAK	M E2 N O L A K 
MENONJOL	M E2 N O NY J O L 
MENONTON	M E2 N O N T O N 
MENPERINDAG	M E N P E2 R I N D A G 
MENSESNEG	M E N S E S N E G 
MENSURVEY	M E2 N S U R F EY 
MENSYUKURI	M E2 NY SY U K U R I 
MENTAH	M E2 N T A H 
MENTAL	M E N T A L 
MENTALNYA	M E N T A L NY A 
MENTERI	M E2 N T E2 R I 
MENUAI	M E2 N U AY 
MENUDUH	M E2 N U D U H 
MENUJU	M E2 N U J U 
MENUKARKAN	M E2 N U K A R K A N 
MENUKARNYA	M E2 N U K A R NY A 
MENU	M E N U 
MENUNAIKAN	M E2 N U N AY K A N 
MENUNGGING-NUNGGING	M E2 N U NG G I NG N U NG G I NG 
MENUNGGU	M E2 N U NG G U 
MENUNJUKKAN	M E2 N U NY J U K K A N 
MENUNJUK	M E2 N U NY J U K 
MENUNTUT	M E2 N U N T U T 
MENUNYA	M E2 N U NY A 
MENURUNKAN	M E2 N U R U N K A N 
MENURUNNYA	M E2 N U R U N NY A 
MENURUT	M E2 N U R U T 
MENURUTNYA	M E2 N U R U T NY A 
MENUTUP-NUTUPI	M E2 N U T U P N U T U P I 
MENUTURKAN	M E2 N U T U R K A N 
MENYADARI	M E2 NY A D A R I 
MENYAHUT	M E2 NY A H U T 
MENYAMAKAN	M E2 NY A M A K A N 
MENYAMAR	M E2 NY A M A R 
MENYAMPAIKAN	M E2 NY A M P AY K A N 
MENYANGKUT	M E2 NY A NG K U T 
MENYANGSIKAN	M E2 NY A NG S I K A N 
MENYANYIKAN	M E2 NY A NY I K A N 
MENYARANKAN	M E2 NY A R A N K A N 
MENYATAKAN	M E2 NY A T A K A N 
MENYEBABKAN	M E2 NY E2 B A B K A N 
MENYEBAR	M E2 NY E2 B A R 
MENYEBUTKAN	M E2 NY E2 B U T K A N 
MENYEBUT-NYEBUT	M E2 NY E2 B U T NY E2 B U T 
MENYEDIAKAN	M E2 NY E2 D I A K A N 
MENYEDIHKAN	M E2 NY E2 D I H K A N 
MENYEGEL	M E2 NY E G E2 L 
MENYEJAHTERAKAN	M E2 NY E2 J A H T E2 R A K A N 
MENYELESAIKAN	M E2 NY E2 L E2 S AY K A N 
MENYEMBUNYIKAN	M E2 NY E2 M B U NY I K A N 
MENYENANGKAN	M E2 NY E2 N A NG K A N 
MENYEPAKATI	M E2 NY E2 P A K A T I 
MENYERAHKAN	M E2 NY E2 R A H K A N 
MENYERAMKAN	M E2 NY E2 R A M K A N 
MENYERANG	M E2 NY E2 R A NG 
MENYERET	M E2 NY E R E T 
MENYERUKAN	M E2 NY E2 R U K A N 
MENYESALINYA	M E2 NY E2 S A L I NY A 
MENYETEL	M E2 NY E2 T E L 
MENYETUJUI	M E2 NY E2 T U J U I 
MENYEWA	M E2 NY E W A 
MENYIBAK	M E2 NY I B A K 
MENYINDIR	M E2 NY I N D I R 
MENYINGGUNG	M E2 NY I NG G U NG 
MENYIRAMKAN	M E2 NY I R A M K A N 
MENYITIR	M E2 NY I T I R 
MENYODORKAN	M E2 NY O D O R K A N 
MENYONTOHKAN	M E2 NY O N T O H K A N 
MENYOROTI	M E2 NY O R O T I 
MENYUAP	M E2 NY U A P 
MENYUDUT-NYUDUTKAN	M E2 NY U D U T NY U D U T K A N 
MENYUGUHKAN	M E2 NY U G U H K A N 
MENYUKAI	M E2 NY U K A I 
MENYUKAINYA	M E2 NY U K A I NY A 
MENYULITKAN	M E2 NY U L I T K A N 
MENYUNDUL	M E2 NY U N D U L 
MENYUPLAI	M E2 NY U P L AY 
MENYURUH	M E2 NY U R U H 
MENYURVEI	M E2 NY U R F EY 
MENYUSUI	M E2 NY U S U I 
MENYUSUL	M E2 NY U S U L 
MERAGUKAN	M E2 R A G U K A N 
MERAH	M E R A H 
MERANGSEK	M E2 R A NG S E2 K 
MERAO	M E2 R A O 
MERAPI	M E2 R A P I 
MERASAKAN	M E2 R A S A K A N 
MERASA	M E2 R A S A 
MERAUKE	M E2 R AW K E 
MERAYAKAN	M E2 R A Y A K A N 
MERCY	M E R S I 
MERDEKA	M E2 R D E K A 
MEREALISASI	M E2 R E2 A L I S A S I 
MEREBUT	M E2 R E2 B U T 
MEREFLEKSIKAN	M E2 R E F L E K S I K A N 
MEREKALAH	M E2 R E K A L A H 
MEREKA	M E2 R E K A 
MEREK	M E R E2 K 
MEREK-MEREK	M E R E2 K M E R E2 K 
MERENGUT	M E2 R E2 NG U T 
MERESAHKAN	M E2 R E2 S A H K A N 
MERESPONS	M E2 R E S P O N S 
MERIAH	M E2 R I A H 
MERINCI	M E2 R I NY C I 
MEROBEK	M E2 R O B E K 
MEROSOT	M E2 R O S O T 
MEROSOTNYA	M E2 R O S O T NY A 
MERUNTUHKAN	M E2 R U N T U H K A N 
MERUPAKAN	M E2 R U P A K A N 
MESIANISME	M E S I A N I S M E2 
MESIN	M E2 S I N 
MESINNYA	M E2 S I N NY A 
MESIR	M E2 S I R 
MESJID	M E2 S J I D 
MESKI	M E2 S K I 
MESKIPUN	M E2 S K I P U N 
MESTI	M E2 S T I 
MESTINYA	M E2 S T I NY A 
METER	M E T E R 
METODE	M E T O D E2 
METRO	M E T R O 
MEWAJIBKAN	M E2 W A J I B K A N 
MEWAKILI	M E2 W A K I L I 
MEWUJUDKAN	M E2 W U J U D K A N 
MEYAKINKAN	M E2 Y A K I N K A N 
MIAMI	M I A M I 
MIDAN	M I D A N 
MIGAS	M I G A S 
MIKE	M AY K 
MIKIR	M I K I R 
MIKRO	M I K R O 
MILIKI	M I L I K I 
MILIK	M I L I K 
MILITAN	M I L I T A N 
MILITER	M I L I T E R 
MILITERNYA	M I L I T E R NY A 
MIMPI-MIMPI	M I M P I M I M P I 
MINANGKABAU	M I N A NG K A B AW 
MINERAL	M I N E2 R A L 
MINGGUAN	M I NG G U A N 
MINGGU	M I NG G U 
MINIMUM	M I N I M U M 
MINTA	M I N T A 
MINUMAN	M I N U M A N 
MINUM	M I N U M 
MINYAK	M I NY A K 
MIRIP	M I R I P 
MIRIP-MIRIP	M I R I P M I R I P 
MIRZA	M I R Z A 
MISALNYA	M I S A L NY A 
MISI	M I S I 
MISKIN	M I S K I N 
MMM	M M 
MOBIL	M O B I L 
MOBILNYA	M O B I L NY A 
MOCHTAR	M O KH T A R 
MODEL	M O D E L 
MODEL-MODEL	M O D E L M O D E L 
MODERAT	M O D E2 R A T 
MODERATOR	M O D E2 R A T O R 
MODERN	M O D E R E2 N 
MODUS	M O D U S 
MOGOK	M O G O K 
MOHON	M O H O N 
MOJOKERTO	M O J O K E2 R T O 
MOLLA	M O L A 
MOLOTOV	M O L O T O F 
MOMEN	M O M E2 N 
MOMENTUM	M O M E2 N T U M 
MONYET	M O NY E T 
MORATORIUM	M O R A T O R I U M 
MORIENTES	M O R I E N T E2 S 
MOTOR	M O T O R 
MOZAIK	M O Z A I K 
MPR	E M P E K E R 
MUARIF	M U K A R I F 
MUATANNYA	M U A T A N NY A 
MUCHSIN	M U KH S I N 
MUCHTAR	M U KH T A R 
MUDAH	M U D A H 
MUDA	M U D A 
MUFAKAT	M U F A K A T 
MUGABE	M U G A B E 
MUHAIMIN	M U H A I M I N 
MUHAMAD	M U H A M A D 
MUHAMMAD	M U H A M A D 
MUHIYI	M U H I Y I 
MUHYI	M U H Y I 
MUIN	M U K I N 
MUKA	M U K A 
MUKHLIS	M U KH L I S 
MUKHTAR	M U KH T A R 
MUKTAMAR	M U K T A M A R 
MULAI	M U L AY 
MULTIDIMENSI	M U L T I D I M E N S I 
MULTI	M U L T I 
MULUT	M U L U T 
MULYANI	M U L Y A N I 
MUNASLUB	M U N A S L U B 
MUNCULLAH	M U NY C U L L A H 
MUNCUL	M U NY C U L 
MUNCULNYA	M U NY C U L NY A 
MUNDUR	M U N D U R 
MUNGKAR	M U NG K A R 
MUNGKIN	M U NG K I N 
MUNIR	M U N I R 
MUNITIS	M U N I T I S 
MURAH	M U R A H 
MURAKAMINYA	M U R A K A M I NY A 
MURDWIONO	M U R D W I O N O 
MURID-MURIDNYA	M U R I D M U R I D NY A 
MURSYIDAN	M U R SY I D A N 
MURTI	M U R T I 
MUSEUM	M U S E U M 
MUSIC	M U S I C 
MUSIKAL	M U S I K A L 
MUSIK	M U S I K 
MUSIM	M U S I M 
MUSLIM	M U S L I M 
MUSTAINE	M U S T A I N E 
MUSTOPO	M U S T O P O 
MUSYAWARAH	M U SY A W A R A H 
MUTU	M U T U 
MUZADI	M U Z A D I 
NABLUS	N A B L U S 
NADA	N A D A 
NAFSU	N A F S U 
NAHI	N A H I 
NAH	N A H 
NAIK	N A I K 
NAJIB	N A J I B 
NAKATA	N A K A T A 
NAMA	N A M A 
NAMANYA	N A M A NY A 
NAMUN	N A M U N 
NANO	N A N O 
NANTI	N A N T I 
NANTINYA	N A N T I NY A 
NARASUMBER	N A R A S U M B E2 R 
NARKOBA	N A R K O B A 
NARKOTIKA	N A R K O T I K A 
NARTO	N A R T O 
NASIB	N A S I B 
NASIBNYA	N A S I B NY A 
NASI	N A S I 
NASIONAL	N A S I O N A L 
NASKAH	N A S K A H 
NATALEGAWA	N A T A L E2 G A W A 
NAWAWI	N A W A W I 
NAZIF	N A Z I F 
NEGARA	N E2 G A R A 
NEGARA-NEGARA	N E2 G A R A N E2 G A R A 
NEGARANYA	N E2 G A R A NY A 
NEGATIF	N E G A T I F 
NEGERI	N E2 G E2 R I 
NEGOSIASI	N E G O S I A S I 
NEIS	N E I S 
NEKAT	N E K A T 
NELAYAN	N E2 L A Y A N 
NEPOTISME	N E P O T I S M E2 
NESTAPA	N E2 S T A P A 
NETRAL	N E T R A L 
NEUROLOGI	N E U R O L O G I 
NGACAU	NG A C AW 
NGACO	NG A C O 
NGAKU	NG A K U 
NGALAH	NG A L A H 
NGALOR-NGIDUL	NG A L O R NG I D U L 
NGAMBEK	NG A M B E2 K 
NGANGGEP	NG A NG G E2 P 
NGANJUK	NG A NY J U K 
NGAPAIN	NG A P A I N 
NGATIYEM	NG A T I Y E2 M 
NGAWI	NG A W I 
NGEBUT-NGEBUTAN	NG E2 B U T NG E2 B U T A N 
NGEDROP	NG E2 D R O P 
NGELABA	NG E2 L A B A 
NGEMPLANG	NG E2 M P L A NG 
NGEPOP	NG E2 P O P 
NGERUBUNG	NG E2 R U B U NG 
NGERUMPI	NG E2 R U M P I 
NGETEM	NG E2 T E M 
NGGAK	NG G A K 
NGOMONG	NG O M O NG 
NGOPI	NG O P I 
NGOTOT	NG O T O T 
NGURUSIN	NG U R U S I N 
NGUYEN	NG U Y E N 
NIAGA	N I A G A 
NIAS	N I A S 
NIKKO	N I K O 
NILAI-NILAI	N I L AY N I L AY 
NILAI	N I L AY 
NINOY	N I N OY 
NITRAT	N I T R A T 
NJOP	E NY J E K O P E 
NOL-NOL	N O L N O L 
NOMOR	N O M O R 
NOMORNYA	N O M O R NY A 
NONA	N O N A 
NONBUDGETER	N O N B A D J E T E2 R 
NON-JOB	N O N J O B 
NONKOOPERATIF	N O N K O K O P E2 R A T I F 
NON	N O N 
NORIT	N O R I T 
NORMAL	N O R M A L 
NOTE	N O T 
NOVAL	N O F A L 
NOVEMBER	N O F E M B E2 R 
NPWP	E N P E W E P E 
NTB	E N T E B E 
NTT	E N T E T E 
NUGROHO	N U G R O H O 
NUNUZ	N U N U Z 
NURCHOLIS	N U R KH O L I S 
NURDIN	N U R D I N 
NURHALIZA	N U R H A L I Z A 
NURMAHMUDI	N U R M A H M U D I 
NUR	N U R 
NURSALIM	N U R S A L I M 
NUSANIWE	N U S A N I W E 
NUSANTARA	N U S A N T A R A 
NUSA	N U S A 
NUWAWEA	N U W A W E A 
NYAI	NY A I 
NYALI	NY A L I 
NYAMAN	NY A M A N 
NYANYI	NY A NY I 
NYARIS	NY A R I S 
NYATANYA	NY A T A NY A 
NYATA	NY A T A 
NYEKAR	NY E2 K A R 
NYENYAK	NY E2 NY A K 
NYERI	NY E2 R I 
NYINYIR	NY I NY I R 
NYIUR	NY I U R 
NYOMAN	NY O M A N 
NYONYA	NY O NY A 
NYUMBANG	NY U M B A NG 
NYUNGSEP	NY U NG S E2 P 
OBAT	O B A T 
OBAT-OBAT	O B A T O B A T 
OBJEKTIF	O B J E K T I F 
OBLIGASI	O B L I G A S I 
OBLIGOR	O B L I G O R 
OBROLAN	O B R O L A N 
OBSERVER	O B S E2 R F E2 R 
OBSTRUKTIF	O B S T R U K T I F 
OBYEK	O B Y E K 
OBYEKTIF	O B Y E K T I F 
OCTAVIO	O K T A F I O 
ODE	O D E 
OEBOBO	U B O B O 
OEMARSONO	U M A R S O N O 
OENTARTO	U N T A R T O 
OFISIAL	O F I S I A L 
OGOH-OGOH	O G O H O G O H 
OH	O H 
OIKUMENE	O I K U M E N E 
OKE	O K E 
OKE-OKE	O K E O K E 
OKI	O K I 
OKLAHOMA	O K L A H O M A 
OKNUM	O K N U M 
OKSIGEN	O K S I G E N 
OKTOBER	O K T O B E2 R 
OLAHRAGA	O L A H R A G A 
OLEH	O L E H 
OLIMPIADE	O L I M P I A D E2 
OMBAK	O M B A K 
OMONGAN	O M O NG A N 
ONCOM	O NY C O M 
ONDE	O N D E 
ONDERDIL	O N D E2 R D I L 
ONGKOSNYA	O NG K O S NY A 
ONGKOS	O NG K O S 
ONH	O K E N H A 
ONKOLOGI	O N K O L O G I 
OPERASIONAL	O P E2 R A S I O N A L 
OPERASI	O P E2 R A S I 
OPERATOR	O P E2 R A T O R 
OPINI	O P I N I 
OPOSISI	O P O S I S I 
OPTIMISME	O P T I M I S M E2 
OPTIMISTIS	O P T I M I S T I S 
ORANGNYA	O R A NG NY A 
ORANG	O R A NG 
ORANG-ORANG	O R A NG O R A NG 
ORGANDA	O R G A N D A 
ORGANISASI	O R G A N I S A S I 
ORISINIL	O R I S I N I L 
ORMAS	O R M A S 
OSAMA	O S A M A 
OSMAN	O S M A N 
OTOMATISNYA	O T O M A T I S NY A 
OTOMATIS	O T O M A T I S 
OTOMOTIF	O T O M O T I F 
OTONOMI	O T O N O M I 
OTOT	O T O T 
OUT	AW T 
OVERDOSIS	O F E2 R D O S I S 
OZY	O Z I 
PABEAN	P A B E A N 
PABRIK	P A B R I K 
PADAHAL	P A D A H A L 
PADAMU	P A D A M U 
PADANG	P A D A NG 
PADANYA	P A D A NY A 
PADA	P A D A 
PADAT	P A D A T 
PADU	P A D U 
PAGI	P A G I 
PAHAMI	P A H A M I 
PAHAM	P A H A M 
PAHANYA	P A H A NY A 
PAHLEVI	P A H L E F I 
PAILIT	P AY L I T 
PAJAK	P A J A K 
PAKAIANNYA	P A K AY A N NY A 
PAKAIAN	P A K AY A N 
PAKAI	P A K AY 
PAKAR	P A K A R 
PAKET	P A K E T 
PAKISTAN	P A K I S T A N 
PAK	P A K 
PALEMBANG	P A L E M B A NG 
PALESTINA	P A L E S T I N A 
PALING	P A L I NG 
PALIUDJU	P A L I U J U 
PALSU	P A L S U 
PAMEO	P A M E O 
PAMSWAKARSA	P A M S W A K A R S A 
PANDANGAN	P A N D A NG A N 
PANDANG	P A N D A NG 
PANDEGLANG	P A N D E G L A NG 
PANGGILAN	P A NG G I L A N 
PANGGIL	P A NG G I L 
PANGGUNG	P A NG G U NG 
PANGKUAN	P A NG K U A N 
PANGLIMA	P A NG L I M A 
PANGSA	P A NG S A 
PANIGORO	P A N I G O R O 
PANITIA	P A N I T I A 
PANJANG	P A NY J A NG 
PAN	P A N 
PANSER	P A N S E2 R 
PANSUS	P A N S U S 
PANTAI	P A N T AY 
PANTAS	P A N T A S 
PANTAUAN	P A N T AW A N 
PANTHEON	P A N T I A N 
PANTI	P A N T I 
PANTURA	P A N T U R A 
PANUTAN	P A N U T A N 
PAPANDAYAN	P A P A N D A Y A N 
PAPUA	P A P U A 
PARAGUAY	P A R A G U AY 
PARAH	P A R A H 
PARA	P A R A 
PARAU	P A R AW 
PARIWISATA	P A R I W I S A T A 
PARK	P A R K 
PARLEMEN	P A R L E2 M E N 
PARPOL	P A R P O L 
PARTAINYA	P A R T AY NY A 
PARTAI	P A R T AY 
PARU	P A R U 
PASANG	P A S A NG 
PASAR	P A S A R 
PASCASARJANA	P A S C A S A R J A N A 
PASKIBRA	P A S K I B R A 
PAS	P A S 
PASPOR	P A S P O R 
PASTI	P A S T I 
PASUKANNYA	P A S U K A N NY A 
PASUKAN	P A S U K A N 
PATAH	P A T A H 
PATUNG-PATUNG	P A T U NG P A T U NG 
PATUT	P A T U T 
PAUS	P A U S 
PAWAI	P A W AY 
PAYAU	P A Y AW 
PBB	P E B E B E 
PBNU	P E B E K E N U 
PDAM	P E D E K A K E M 
PDI	P E D E K I 
PDI-PERJUANGAN	P E D E I P E2 R J U A NG A N 
PDIP	P E D E K I P E 
PEBULUTANGKIS	P E2 B U L U T A NG K I S 
PECAHAN	P E2 C A H A N 
PECAH	P E2 C A H 
PECAT	P E2 C A T 
PECI	P E C I 
PEDAGANG	P E2 D A G A NG 
PEDAS	P E2 D A S 
PEDOMANNYA	P E2 D O M A N NY A 
PEDONGKELAN	P E2 D O NG K E L A N 
PEDRO	P E D R O 
PEDULI	P E2 D U L I 
PEGAWAINYA	P E2 G A W AY NY A 
PEGAWAI	P E2 G A W AY 
PEGUNUNGAN	P E2 G U N U NG A N 
PEJABAT	P E2 J A B A T 
PEKAN	P E2 K A N 
PEKERJAAN	P E2 K E2 R J A K A N 
PELAKSANA	P E2 L A K S A N A 
PELAKU	P E2 L A K U 
PELANGGANNYA	P E2 L A NG G A NY A 
PELANGGARAN	P E2 L A NG G A R A N 
PELAN	P E2 L A N 
PELANTIKAN	P E2 L A N T I K A N 
PELAPOR	P E2 L A P O R 
PELARI	P E2 L A R I 
PELATIH	P E2 L A T I H 
PELATNAS	P E2 L A T N A S 
PELAYANAN	P E2 L A Y A N A N 
PELAYAN	P E2 L A Y A N 
PELAYARAN	P E2 L A Y A R A N 
PELEDAKAN	P E2 L E2 D A K A N 
PELETON	P E2 L E2 T O N 
PELNI	P E L N I 
PELUANG-PELUANG	P E2 L U A NG P E2 L U A NG 
PELURU	P E2 L U R U 
PEMADAMAN	P E2 M A D A M A N 
PEMAIN	P E2 M A I N 
PEMAKAI	P E2 M A K AY 
PEMANDANGAN	P E2 M A N D A NG A N 
PEMANDANG	P E2 M A N D A NG 
PEMASARAN	P E2 M A S A R A N 
PEMBACAAN	P E2 M B A C A K A N 
PEMBACANYA	P E2 M B A C A NY A 
PEMBAGIAN	P E2 M B A G I A N 
PEMBAHASANNYA	P E2 M B A H A S A N NY A 
PEMBAKARAN	P E2 M B A K A R A N 
PEMBANGUNAN	P E2 M B A NG U N A N 
PEMBAYARANNYA	P E2 M B A Y A R A N NY A 
PEMBAYARAN	P E2 M B A Y A R A N 
PEMBELAAN	P E2 M B E L A K A N 
PEMBELA	P E2 M B E L A 
PEMBELIAN	P E2 M B E2 L I A N 
PEMBENTUKAN	P E2 M B E2 N T U K A N 
PEMBERIAN	P E2 M B E2 R I A N 
PEMBERITAAN	P E2 M B E2 R I T A K A N 
PEMBERITAHUAN	P E2 M B E2 R I T A U A N 
PEMBERLAKUAN	P E2 M B E2 R L A K U A N 
PEMBINA	P E2 M B I N A 
PEMBOMAN	P E2 M B O M A N 
PEMBUANGAN	P E2 M B U A NG A N 
PEMBUKA	P E2 M B U K A 
PEMBUNUHAN	P E2 M B U N U H A N 
PEMDA	P E M D A 
PEMDAPROV	P E M D A P R O F 
PEMEGANG	P E2 M E2 G A NG 
PEMELIHARAAN	P E2 M E2 L I H A R A K A N 
PEMENANG	P E2 M E2 N A NG 
PEMERIKSAAN	P E2 M E2 R I K S A K A N 
PEMERINTAHAN	P E2 M E2 R I N T A H A N 
PEMERINTAH	P E2 M E2 R I N T A H 
PEMESANAN	P E2 M E2 S A N A N 
PEMICU	P E2 M I C U 
PEMILIHAN	P E2 M I L I H A N 
PEMILIK	P E2 M I L I K 
PEMIMPIN	P E2 M I M P I N 
PEMINDAHAN	P E2 M I N D A H A N 
PEMKAB	P E2 M K A B 
PEMKOT	P E M K O T 
PEMPROP	P E2 M P R O P 
PEMPROV	P E2 M P R O F 
PEMRED	P E2 M R E D 
PEMUDA	P E2 M U D A 
PEMULA	P E2 M U L A 
PENAHANANNYA	P E2 N A H A N A N NY A 
PENAHANAN	P E2 N A H A N A N 
PENALTI	P E N A L T I 
PENAMBANG	P E2 N A M B A NG 
PENAMPILAN	P E2 N A M P I L A N 
PENANGANAN	P E2 N A NG A N A N 
PENANGGUNGJAWAB	P E2 N A NG G U NG J A W A B 
PENANGKAPAN	P E2 N A NG K A P A N 
PENARI	P E2 N A R I 
PENASIHAT	P E2 N A S I H A T 
PENCALONAN	P E2 NY C A L O N A N 
PENCERAMAH	P E2 NY C E2 R A M A H 
PENCURI	P E2 NY C U R I 
PENDAKIAN	P E2 N D A K I A N 
PENDAKWAH	P E2 N D A K W A H 
PENDAPATAN	P E2 N D A P A T A N 
PENDAPAT	P E2 N D A P A T 
PENDATAAN	P E2 N D A T A K A N 
PENDEK	P E N D E K 
PENDERITA	P E2 N D E2 R I T A 
PENDIDIKAN	P E2 N D I D I K A N 
PENDIDIK	P E2 N D I D I K 
PENDUDUK	P E2 N D U D U K 
PENDUKUNGNYA	P E2 N D U K U NG NY A 
PENDUKUNG	P E2 N D U K U NG 
PENEBANGAN	P E2 N E2 B A NG A N 
PENEDUH	P E2 N E2 D U H 
PENEKAN	P E2 N E2 K A N 
PENELITIAN	P E2 N E2 L I T I A N 
PENELITI	P E2 N E2 L I T I 
PENEMBAKAN	P E2 N E M B A K A N 
PENENTUAN	P E2 N E2 N T U A N 
PENERANGAN	P E2 N E2 R A NG A N 
PENERAPAN	P E2 N E2 R A P A N 
PENERBANGAN	P E2 N E2 R B A NG A N 
PENERIMAAN	P E2 N E2 R I M A K A N 
PENERTIBAN	P E2 N E2 R T I B A N 
PENGACARA	P E2 NG A C A R A 
PENGADAAN	P E2 NG A D A K A N 
PENGADILAN	P E2 NG A D I L A N 
PENGAJAR	P E2 NG A J A R 
PENGAKUAN	P E2 NG A K U A N 
PENGAMAN	P E2 NG A M A N 
PENGAMATAN	P E2 NG A M A T A N 
PENGAMAT	P E2 NG A M A T 
PENGARAHAN	P E2 NG A R A H A N 
PENGARUHI	P E2 NG A R U H I 
PENGARUH	P E2 NG A R U H 
PENGASUH	P E2 NG A S U H 
PENGAWAS	P E2 NG A W A S 
PENGAYOM	P E2 NG A Y O M 
PENGCAB	P E2 NG C A B 
PENGECER	P E2 NG E C E R 
PENGEDAR	P E2 NG E D A R 
PENGEMBANGAN	P E2 NG E2 M B A NG A N 
PENGENAL	P E2 NG E2 N A L 
PENGEROYOKAN	P E2 NG E2 R O Y O K A N 
PENGGANTI	P E2 NG G A N T I 
PENGGEMAR	P E2 NG G E2 M A R 
PENGHARGAAN	P E2 NG H A R G A K A N 
PENGHEMATAN	P E2 NG H E M A T A N 
PENGIRIMAN	P E2 NG I R I M A N 
PENGKHIANAT	P E2 NG KH I A N A T 
PENGOPLOSAN	P E2 NG O P L O S A N 
PENGUBURAN	P E2 NG U B U R A N 
PENGUJIAN	P E2 NG U J I A N 
PENGUNDURAN	P E2 NG U N D U R A N 
PENGUNGSIAN	P E2 NG U NG S I A N 
PENGUNGSI	P E2 NG U NG S I 
PENGUNJUNG	P E2 NG U NY J U NG 
PENGURUS	P E2 NG U R U S 
PENGUSAHA	P E2 NG U S A H A 
PENILAIANNYA	P E2 N I L AY A N NY A 
PENINGKATAN	P E2 N I NG K A T A N 
PENIPUAN	P E2 N I P U A N 
PENITIPAN	P E2 N I T I P A N 
PENITI	P E2 N I T I 
PENJAHAT	P E2 NY J A H A T 
PENJAJA	P E2 NY J A J A 
PENJELASAN	P E2 NY J E2 L A S A N 
PENJUALAN	P E2 NY J U A L A N 
PENJUAL	P E2 NY J U A L 
PENUH	P E2 N U H 
PENUMPANG	P E2 N U M P A NG 
PENURUNAN	P E2 N U R U N A N 
PENYAKIT	P E2 NY A K I T 
PENYAMPAIAN	P E2 NY A M P AY A N 
PENYANYI	P E2 NY A NY I 
PENYANYI-PENYANYI	P E2 NY A NY I P E2 NY A NY I 
PENYEBAB	P E2 NY E2 B A B 
PENYEBERANGAN	P E2 NY E2 B E2 R A NG A N 
PENYEHATAN	P E2 NY E H A T A N 
PENYELESAIAN	P E2 NY E2 L E2 S AY A N 
PENYELEWENGAN	P E2 NY E2 L E W E NG A N 
PENYELUNDUPAN	P E2 NY E2 L U N D U P A N 
PENYEMPURNAAN	P E2 NY E2 M P U R N A K A N 
PENYERAHAN	P E2 NY E2 R A H A N 
PENYIDIKAN	P E2 NY I D I K A N 
PENYIDIK	P E2 NY I D I K 
PENYIMPANGAN	P E2 NY I M P A NG A N 
PENYISIHAN	P E2 NY I S I H A N 
PENYITAAN	P E2 NY I T A K A N 
PENYOK	P E NY O K 
PENYU	P E2 NY U 
PENYUSUP	P E2 NY U S U P 
PERABOTAN	P E2 R A B O T A N 
PERADILAN	P E2 R A D I L A N 
PERAHU	P E2 R A H U 
PERALATAN	P E2 R A L A T A N 
PERANCIS	P E2 R A NY C I S 
PERANGAINYA	P E2 R A NG AY NY A 
PERANGKO	P E2 R A NG K O 
PERANG	P E2 R A NG 
PERANTAUAN	P E2 R A N T AW A N 
PERAWATAN	P E2 R A W A T A N 
PERBAIKAN	P E2 R B A I K A N 
PERBAIKI	P E2 R B A I K I 
PERBUATAN	P E2 R B U A T A N 
PERCEPATAN	P E2 R C E2 P A T A N 
PERDAGANGANNYA	P E2 R D A G A NG A N NY A 
PERDAGANGAN	P E2 R D A G A NG A N 
PERDAMAIAN	P E2 R D A M AY A N 
PERDANAKUSUMA	P E2 R D A N A K U S U M A 
PERDA	P E2 R D A 
PEREDARAN	P E2 R E2 D A R A N 
PEREMPUAN	P E2 R E2 M P U A N 
PERGELANGAN	P E2 R G E2 L A NG A N 
PERGELARAN	P E2 R G E2 L A R A N 
PERGERAKANNYA	P E2 R G E2 R A K A N NY A 
PERGI	P E2 R G I 
PERGURUAN	P E2 R G U R U A N 
PERHITUNGAN	P E2 R H I T U NG A N 
PERHOTELAN	P E2 R H O T E L A N 
PERIHAL	P E2 R I H A L 
PERIKLANAN	P E2 R I K L A N A N 
PERIKSA	P E2 R I K S A 
PERIMBANGAN	P E2 R I M B A NG A N 
PERINGATAN	P E2 R I NG A T A N 
PERINTAH	P E2 R I N T A H 
PERINTIS	P E2 R I N T I S 
PERISTIWA	P E2 R I S T I W A 
PERIUK	P E2 R I U K 
PERJALANAN	P E2 R J A L A N A N 
PERJANJIAN	P E2 R J A NY J I A N 
PERJUANGAN	P E2 R J U A NG A N 
PERKAMPUNGAN	P E2 R K A M P U NG A N 
PERKASA	P E2 R K A S A 
PERKATAAN	P E2 R K A T A K A N 
PERKELAHIAN	P E2 R K E2 L A H I A N 
PERKENALAN	P E2 R K E2 N A L A N 
PERKENALKAN	P E2 R K E2 N A L K A N 
PERKIRAAN	P E2 R K I R A K A N 
PERLAHAN-LAHAN	P E2 R L A H A N L A H A N 
PERLAKUAN	P E2 R L A K U A N 
PERLUNYA	P E2 R L U NY A 
PERLU	P E2 R L U 
PERMINTAAN	P E2 R M I N T A K A N 
PERMISI	P E2 R M I S I 
PERNAHKAH	P E2 R N A H K A H 
PERNAH	P E2 R N A H 
PERNYATAAN	P E2 R NY A T A K A N 
PEROKOK	P E2 R O K O 
PERON	P E R O N 
PERPANJANGAN	P E2 R P A NY J A NG A N 
PER	P E R 
PERPLONCOAN	P E2 R P L O NY C O A N 
PERRIER	P E R I E2 R 
PERSAINGAN	P E2 R S AY NG A N 
PERSATUAN	P E2 R S A T U A N 
PERSEMBUNYIAN	P E2 R S E2 M B U NY I A N 
PERSEPSI	P E2 R S E P S I 
PERSERIKATAN	P E2 R S E2 R I K A T A N 
PERSIAPAN	P E2 R S I A P A N 
PERSONEL	P E2 R S O N E L 
PERS	P E R S 
PERSYARATAN	P E2 R SY A R A T A N 
PERTAHANAN	P E2 R T A H A N A N 
PERTAMA	P E2 R T A M A 
PERTAMINA	P E2 R T A M I N A 
PERTANYAAN	P E2 R T A NY A K A N 
PERTEMUAN	P E2 R T E2 M U A N 
PERTENGAHAN	P E2 R T E2 NG A H A N 
PERTIKAIAN	P E2 R T I K AY A N 
PERTIMBANGAN	P E2 R T I M B A NG A N 
PERTOKOAN	P E2 R T O K O A N 
PERTUNJUKAN	P E2 R T U NY J U K A N 
PERUBAHAN	P E2 R U B A H A N 
PERUNGGU	P E2 R U NG G U 
PERUSAHAANNYA	P E2 R U S A H A K A N NY A 
PERUSAHAAN	P E2 R U S A H A K A N 
PERUSAHAAN-PERUSAHAAN	P E2 R U S A H A K A N P E2 R U S A H A K A N 
PERUSAHAN	P E2 R U S A H A N 
PERUSAKAN	P E2 R U S A K A N 
PERUT	P E2 R U T 
PERWAKILAN	P E2 R W A K I L A N 
PERWAKILAN-PERWAKILAN	P E2 R W A K I L A N P E2 R W A K I L A N 
PESANAN	P E2 S A N A N 
PESANKAN	P E2 S A N K A N 
PESAN	P E2 S A N 
PESANTREN	P E2 S A N T R E N 
PESAWAT	P E2 S A W A T 
PESERTA	P E2 S E2 R T A 
PESIMIS	P E2 S I M I S 
PESISIR	P E2 S I S I R 
PESTA	P E S T A 
PETAMBAK	P E2 T A M B A K 
PETANI	P E2 T A N I 
PETA	P E2 T A 
PETIKAN	P E2 T I K A N 
PETROKIMIA	P E T R O K I M I A 
PETUGAS	P E2 T U G A S 
PEZIARAH	P E2 Z I A R A H 
PHILIPINA	P H I L I P I N A 
PIALA	P I A L A 
PIAWAI	P I A W AY 
PIDATONYA	P I D A T O NY A 
PIDATO	P I D A T O 
PIHAKNYA	P I H A K NY A 
PIHAK	P I H A K 
PILIHAN	P I L I H A N 
PILIHLAH	P I L I H L A H 
PILIH	P I L I H 
PILIH-PILIH	P I L I H P I L I H 
PILOT	P I L O T 
PIMPINAN	P I M P I N A N 
PINDAH	P I N D A H 
PINGGIRAN	P I NG G I R A N 
PINGGIR	P I NG G I R 
PINGSAN	P I NG S A N 
PINJAMANNYA	P I NY J A M A N NY A 
PINJAMAN	P I NY J A M A N 
PINTAR	P I N T A R 
PINTER	P I N T E2 R 
PINTU	P I N T U 
PIRING	P I R I NG 
PISAU	P I S AW 
PISTOL	P I S T O L 
PIUTANG	P I U T A NG 
PJS	P E J E K E S 
PKB	P E K A B E 
PLASA	P L A S A 
PLATFORM	P L A T F O R M 
PLATINUM	P L A T I N U M 
PLAZA	P L A Z A 
PLEDOI	P L E D O I 
PLEIDOI	P L E I D O I 
PLENO	P L E N O 
PLESTER	P L E S T E2 R 
PLN	P E K E L E N 
PLURALITAS	P L U R A L I T A S 
PLUS	P L U S 
POHON	P O H O N 
POKOKNYA	P O K O K NY A 
POKOK	P O K O K 
POLA	P O L A 
POLDA	P O L D A 
POLEMIK	P O L E2 M I K 
POLISI	P O L I S I 
POLITIK	P O L I T I K 
POLRES	P O L R E S 
POLRESTA	P O L R E S T A 
POLRI	P O L R I 
POLSEK	P O L S E K 
POLSOSKAM	P O L S O S K A M 
POLWIL	P O L W I L 
POLWILTABES	P O L W I L T A B E S 
PONCOL	P O NY C O L 
PONDOK	P O N D O K 
PONOROGO	P O N O R O G O 
PONPES	P O N P E S 
POP	P O P 
PORNOGRAFI	P O R N O G R A F I 
PORSI	P O R S I 
POSISINYA	P O S I S I NY A 
POSISI	P O S I S I 
POSITIF	P O S I T I F 
POSKO	P O S K O 
POSKO-POSKO	P O S K O P O S K O 
POSO	P O S O 
POS	P O S 
POSTER	P O S T E2 R 
POSYANDU	P O SY A N D U 
POTONGAN	P O T O NG A N 
POTONG	P O T O NG 
POTRET	P O T R E T 
PP	P E P E 
PRADJOTO	P R A J O T O 
PRAHA	P R A H A 
PRAJURIT	P R A J U R I T 
PRAKTISI	P R A K T I S I 
PRAKTIS	P R A K T I S 
PRAM	P R A M 
PRAMUDYA	P R A M U D Y A 
PRASETYO	P R A S E T Y O 
PREMAN	P R E M A N 
PREMIUM	P R E M I U M 
PREROGATIF	P R E2 R O G A T I F 
PREROGRATIF	P R E R O G R A T I F 
PRESIDEN	P R E S I D E N 
PRESLEY	P R E S L EY 
PRESTASI	P R E S T A S I 
PREVENTIF	P R E F E N T I F 
PRIA	P R I A 
PRIHATINKAN	P R I H A T I N K A N 
PRIMADONA	P R I M A D O N A 
PRINSIPNYA	P R I N S I P NY A 
PRINSIP-PRINSIP	P R I N S I P P R I N S I P 
PRIVATISASI	P R I F A T I S A S I 
PRIYO	P R I Y O 
PROBLEM	P R O B L E2 M 
PROBOSUTEDJO	P R O B O S U T E J O 
PRODUKSI	P R O D U K S I 
PROGRAM	P R O G R A M 
PROGRESIF	P R O G R E S I F 
PRO-INTEGRASI	P R O I N T E2 G R A S I 
PROPINSI	P R O P I N S I 
PROPORSIONAL	P R O P O R S I O N A L 
PRO	P R O 
PROSEDURNYA	P R O S E2 D U R NY A 
PROSEDUR	P R O S E2 D U R 
PROSESNYA	P R O S E S NY A 
PROSES	P R O S E S 
PROTES	P R O T E S 
PROVINSI	P R O F I N S I 
PROVOKATOR	P R O F O K A T O R 
PROVOS	P R O F O S 
PROYEK	P R O Y E K 
PRUMPUNG	P R U M P U NG 
PSIKIATER	P S I K I A T E2 R 
PSIKOLOGIS	P S I K O L O G I S 
PSIKOLOG	P S I K O L O G 
PT	P E T E 
PUBLIK	P U B L I K 
PUCUK	P U C U K 
PUDAR	P U D A R 
PUING-PUING	P U I NG P U I NG 
PUISI	P U I S I 
PULANG	P U L A NG 
PULA	P U L A 
PULAU-PULAU	P U L AW P U L AW 
PULAU	P U L AW 
PULUHAN	P U L U H A N 
PULUH	P U L U H 
PUNCAK	P U NY C A K 
PUNGUTAN	P U NG U T A N 
PUN	P U N 
PUNYA	P U NY A 
PUPUK	P U P U K 
PURBA	P U R B A 
PURNOMO	P U R N O M O 
PURWOREJO	P U R W O R E2 J O 
PUSARA	P U S A R A 
PUSAT	P U S A T 
PUSING	P U S I NG 
PUSLABFOR	P U S L A B F O R 
PUSPOYO	P U S P O Y O 
PUTARAN	P U T A R A N 
PUTAU	P U T AW 
PUTIH	P U T I H 
PUTRA	P U T R A 
PUTUSAN	P U T U S A N 
PUTUS	P U T U S 
PUYUH	P U Y U H 
PWNU	P E W E K E N U 
QATAR	KH A T A R 
QODRI	K O D R I 
QUO	K U O 
RABIES	R A B I E S 
RABU	R A B U 
RACHBINI	R A KH B I N I 
RADIO	R A D I O 
RAGAM	R A G A M 
RAGUKAN	R A G U K A N 
RAHARDI	R A H A R D I 
RAHMAT	R A H M A T 
RAIS	R A K I S 
RAJA	R A J A 
RAKERNAS	R A K E2 R N A S 
RAKITAN	R A K I T A N 
RAKSASA	R A K S A S A 
RAKYAT	R A K Y A T 
RAMADHAN	R A M A D A N 
RAMAH	R A M A H 
RAMAI-RAMAINYA	R A M AY R A M AY NY A 
RAMAI-RAMAI	R A M AY R A M AY 
RAMAI	R A M AY 
RAMALLAH	R A M A L A H 
RAMBUT	R A M B U T 
RAMDLON	R A M D L O N 
RAMELOW	R A M E L O W 
RAMLI	R A M L I 
RANGKA	R A NG K A 
RANJANG	R A NY J A NG 
RANTAI	R A N T AY 
RAPAT	R A P A T 
RAPEL	R A P E L 
RAPI	R A P I 
RASANYA	R A S A NY A 
RASA	R A S A 
RASIO	R A S I O 
RASYIDI	R A SY I D I 
RASYID	R A SY I D 
RATA-RATA	R A T A R A T A 
RATUSAN	R A T U S A N 
RATUS	R A T U S 
RAUF	R A K U F 
RAWAT	R A W A T 
REAKSI	R E A K S I 
REBOISASI	R E B O I S A S I 
REBUS	R E2 B U S 
RECEH	R E C E H 
REDJEKI	R E2 J E2 K I 
RE-EKSPOR	R E E K S P O R 
REFERENDUM	R E F E2 R E N D U M 
REFERENSI	R E F E2 R E N S I 
REFLEKSI	R E2 F L E K S I 
REFORMASI	R E F O R M A S I 
REFORMIS	R E F O R M I S 
REGIONAL	R E G I O N A L 
REGULER	R E G U L E R 
REJIM	R E J I M 
REKAMAN	R E2 K A M A N 
REKANNYA	R E2 K A N NY A 
REKENING	R E K E2 N I NG 
REKOMENDASIKAN	R E K O M E2 N D A S I K A N 
REKREASI	R E K R E A S I 
REKSA	R E2 K S A 
RELATIF	R E L A T I F 
RELEVANSINYA	R E L E2 F A N S I NY A 
RELIGIUS	R E L I J I U S 
RELOKASI	R E L O K A S I 
REL	R E L 
REMBUG	R E2 M B U G 
REMNYA	R E M NY A 
REM	R E M 
REM-REM	R E M R E M 
RENANG	R E2 N A NG 
RENCANA	R E2 NY C A N A 
RENDAHNYA	R E2 N D A H NY A 
RENDAH	R E2 N D A H 
REOG	R E O G 
REPARASI	R E P A R A S I 
REPORTER	R E P O R T E2 R 
REPROAKTIF	R E P R O A K T I F 
REPUBLIK	R E P U B L I K 
RERUNTUHAN	R E2 R U N T U H A N 
RESEP	R E2 S E P 
RESERSE	R E2 S E R S E2 
RESERVASI	R E S E2 R F A S I 
RESIKO	R E S I K O 
RESITAL	R E S I T A L 
RESMI	R E2 S M I 
RESOLUSI-RESOLUSI        R E S O L U S I R E S O L U S I
RESPON	R E S P O N 
RESPONSIF	R E S P O N S I F 
RESTORAN	R E S T O R A N 
RESTRUKTURISASI	R E S T R U K T U R I S A S I 
RETAK	R E2 T A K 
REUNIFIKASI	R E U N I F I K A S I 
REVISI	R E F I S I 
REVOLUSI	R E F O L U S I 
REVOLVER	R E F O L F E2 R 
REYOT	R E Y O T 
REZA	R E Z A 
REZEKINYA	R E Z E K I NY A 
REZEKI	R E2 Z E2 K I 
REZIM	R E Z I M 
REZLAN	R E Z L A N 
RIAU	R I A U 
RIBUAN	R I B U A N 
RIBU	R I B U 
RICUH	R I C U H 
RI	E R I 
RINCI	R I NY C I 
RINGAN	R I NG A N 
RINING	R I N I NG 
RISET	R I S E2 T 
RISIKO	R I S I K O 
RISWANDHA	R I S W A N D A 
RITONGA	R I T O NG A 
RIUH	R I U H 
RIYANTO	R I Y A N T O 
RIZAL	R I Z A L 
RIZIEQ	R I Z I K 
RIZKI	R I Z K I 
ROBBY	R O B I 
ROCHIMAT	R O KH I M A T 
ROCHMAN	R O KH M A N 
RODA	R O D A 
ROIS	R O K I S 
ROJI	R O J I 
ROKOK	R O K O K 
ROL	R O L 
ROMBONGAN	R O M B O NG A N 
ROMLY	R O M L I 
ROMMY	R O M I 
RONDE	R O N D E2 
ROSBIRI	R O S B I R I 
ROSIHAN	R O S I H A N 
ROSSYATI	R O SY A T I 
ROTI	R O T I 
ROYONG	R O Y O NG 
ROY	R OY 
RRC	E R E R C E 
RSCM	E R E S C E K E M 
RS	E R E S 
RSUD	E R E S U D E 
RSU	E R E S U 
RT	E R T E 
RUANGAN	R U A NG A N 
RUANG	R U A NG 
RUANG-WAKTU	R U A NG W A K T U 
RUCHYAT	R U KH Y A T 
RUCI	R U C I 
RUDOLPH	R U D O L F 
RUGI	R U G I 
RUHUT	R U H U T 
RUJUKAN	R U J U K A N 
RULLY	R U L I 
RUMAHNYA	R U M A H NY A 
RUMAH	R U M A H 
RUMAH-RUMAH	R U M A H R U M A H 
RUMIT	R U M I T 
RUMOR	R U M O R 
RUMP	R U M 
RUMPUT	R U M P U T 
RUMSFELD	R U M S F E L D 
RUMUSAN	R U M U S A N 
RUNTUHNYA	R U N T U H NY A 
RUPANYA	R U P A NY A 
RUPIAH	R U P I A H 
RUPS	E R U P E K E S 
RUSAK	R U S A K 
RUSKANDAR	R U S K A N D A R 
RUSLANI	R U S L A N I 
RUTE	R U T E2 
RUU	E R U K U 
RW	E R W E 
RYACUDU	R I Y A K U D U 
RYAMIZARD	R I A M I Z A R T 
SAATNYA	S A K A T NY A 
SAAT	S A K A T 
SABARLAH	S A B A R L A H 
SABARNO	S A B A R N O 
SABETAN	S A B E2 T A N 
SABIRIN	S A B I R I N 
SABIT	S A B I T 
SABTU	S A B T U 
SABUK	S A B U K 
SABUT	S A B U T 
SADAR	S A D A R 
SAEFULLOH	S A E F U L O H 
SAFNIL	S A F N I L 
SAHAM	S A H A M 
SAHID	S A H I D 
SAH-SAH	S A H S A H 
SAHUR	S A H U R 
SAILENDRA	S AY L E N D R A 
SAJA	S A J A 
SAKING	S A K I NG 
SAKIT	S A K I T 
SAKSI	S A K S I 
SALAH	S A L A H 
SALAMAN	S A L A M A N 
SALDI	S A L D I 
SALEH	S A L E H 
SALING	S A L I NG 
SALMON	S A M E2 N 
SALVADOR	S A L F A D O R 
SAMA	S A M A 
SAMA-SAMA	S A M A S A M A 
SAMBIL	S A M B I L 
SAMBUAGA	S A M B U A G A 
SAMBUNGKAN	S A M B U NG K A N 
SAMBUNG	S A M B U NG 
SAMPAIKAN	S A M P AY K A N 
SAMPAILAH	S A M P AY L A H 
SAMPAI-SAMPAI	S A M P AY S A M P AY 
SAMPAI	S A M P AY 
SAMPING	S A M P I NG 
SAMUDRA	S A M U D R A 
SAMUEL	S A M U E L 
SANA	S A N A 
SANDWICH	S E N D W I C  
SANGAT	S A NG A T 
SANG	S A NG 
SANJAYA	S A NY J A Y A 
SANKSI	S A NG S I 
SANTAP	S A N T A P 
SANTOSO	S A N T O S O 
SANUR	S A N U R 
SAPAAN	S A P A K A N 
SAPUAN	S A P U A N 
SARAPAN	S A R A P A N 
SARUNG	S A R U NG 
SATO	S A T O  
SATPOL	S A T P O L 
SATUAN	S A T U A N 
SATUNYA	S A T U NY A 
SATU	S A T U 
SATU-SATUNYA	S A T U S A T U NY A 
SAUDARANYA	S AW D A R A NY A 
SAUDARA	S AW D A R A 
SAWO	S A W O 
SAYANGNYA	S A Y A NG NY A 
SAYANG	S A Y A NG 
SAYA	S A Y A 
SAYED	S A Y E D 
SCHUBERT	S K U B E2 R T 
SEABAD	S E2 K A B A D 
SEANDAINYA	S E2 K A N D AY NY A 
SEBAB	S E2 B A B 
SEBAB-SEBAB	S E2 B A B S E2 B A B 
SEBAGAINYA	S E2 B A G AY NY A 
SEBAGAI	S E2 B A G AY 
SEBAGIAN	S E2 B A G I A N 
SEBAHU	S E2 B A H U 
SEBAIKNYA	S E2 B A I K NY A 
SEBALIKNYA	S E2 B A L I K NY A 
SEBANYAK	S E2 B A NY A K 
SEBELAH	S E2 B E2 L A H 
SEBELAS	S E2 B E2 L A S 
SEBELUMNYA	S E2 B E2 L U M NY A 
SEBELUM	S E2 B E2 L U M 
SEBENARNYA	S E2 B E2 N A R NY A 
SEBENTAR	S E2 B E2 N T A R 
SEBUAH	S E2 B U A H 
SEBUNGKUS	S E2 B U NG K U S 
SECANGKIR	S E2 C A NG K I R 
SECARA	S E2 C A R A 
SEDANGKAN	S E2 D A NG K A N 
SEDANG	S E2 D A NG 
SEDAN	S E D A N 
SEDAP	S E2 D A P 
SEDERHANA	S E2 D E2 R H A N A 
SEDIAKAN	S E2 D I A K A N 
SEDIKITNYA	S E2 D I K I T NY A 
SEDIKIT	S E2 D I K I T 
SEDYONO	S E2 D Y O N O 
SEFRONTAL	S E2 F R O N T A L 
SEGALANYA	S E2 G A L A NY A 
SEGALA	S E2 G A L A 
SEGELAS	S E2 G E2 L A S 
SEGENAP	S E2 G E2 N A P 
SEGERA	S E2 G E2 R A 
SEGITIGA	S E2 G I T I G A 
SEHARGA	S E2 H A R G A 
SEHARI-HARI	S E2 H A R I H A R I 
SEHARI	S E2 H A R I 
SEHARUSNYA	S E2 H A R U S NY A 
SEHAT	S E H A T 
SEHELAI	S E2 H E2 L AY 
SEHINGGA	S E2 H I NG G A 
SEINE	S EY N I 
SEJAK	S E2 J A K 
SEJALAN	S E2 J A L A N 
SEJAUH	S E2 J A U H 
SEJUMLAH	S E2 J U M L A H 
SEJUTA	S E2 J U T A 
SEKADAR	S E2 K A D A R 
SEKALIAN	S E2 K A L I A N 
SEKALIGUS	S E2 K A L I G U S 
SEKALIPUN	S E2 K A L I P U N 
SEKALI	S E2 K A L I 
SEKARANG	S E2 K A R A NG 
SEKEDAR	S E2 K E2 D A R 
SEKITAR	S E2 K I T A R 
SEKJEN	S E K J E N 
SEKOLAH	S E2 K O L A H 
SEKONYONG-KONYONG	S E2 K O NY O NG K O NY O NG 
SEKRETARIAT	S E2 K R E2 T A R I A T 
SEKRETARIS	S E2 K R E2 T A R I S 
SEKSI	S E K S I 
SEKURITAS	S E2 K U R I T A S 
SELADA	S E2 L A D A 
SELAIN	S E2 L A I N 
SELAKU	S E2 L A K U 
SELALU	S E2 L A L U 
SELAMA	S E2 L A M A 
SELAMAT	S E2 L A M A T 
SELANCAR	S E2 L A NY C A R 
SELANJUTNYA	S E2 L A NY J U T NY A 
SELASA	S E2 L A S A 
SELATAN	S E2 L A T A N 
SELESAINYA	S E2 L E2 S AY NY A 
SELESAI	S E2 L E2 S AY 
SELISIH	S E2 L I S I H 
SELNYA	S E L NY A 
SELONGSONGNYA	S E2 L O NG S O NG NY A 
SELULER	S E L U L E R 
SELURUH	S E2 L U R U H 
SEMAKIN	S E2 M A K I N 
SEMALAM	S E2 M A L A M 
SEMARANG	S E2 M A R A NG 
SEMASA	S E2 M A S A 
SEMATA	S E2 M A T A 
SEMBAKO	S E2 M B A K O 
SEMBARI	S E2 M B A R I 
SEMBILAN	S E2 M B I L A N 
SEMBUNYI-SEMBUNYI	S E2 M B U NY I S E2 M B U NY I 
SEMEN	S E2 M E N 
SEMENTARA	S E2 M E2 N T A R A 
SEMINGGU	S E2 M I NG G U 
SEMOGA	S E2 M O G A 
SEMPAT	S E2 M P A T 
SEMPIT	S E2 M P I T 
SEMPURNA	S E2 M P U R N A 
SEMRAWUT	S E2 M R A W U T 
SEMUANYA	S E2 M U A NY A 
SEMUA	S E2 M U A 
SEMULA	S E2 M U L A 
SENADA	S E2 N A D A 
SENANG	S E2 N A NG 
SENANTIASA	S E2 N A N T I A S A 
SENAYAN	S E2 N A Y A N 
SENDIRIAN	S E2 N D I R I A N 
SENDIRI	S E2 N D I R I 
SENEN	S E2 N E N 
SENGAJA	S E2 NG A J A 
SENGKETA	S E2 NG K E T A 
SENIOR	S E N I O R 
SENJATANYA	S E2 NY J A T A NY A 
SENJATA	S E2 NY J A T A 
SENO	S E N O 
SEN	S E N 
SENTIMEN	S E N T I M E N 
SENYUMAN	S E2 NY U M A N 
SEORANG	S E2 K O R A NG 
SEPAKAT	S E2 P A K A T 
SEPAK	S E P A K 
SEPANDAI-PANDAINYA	S E2 P A N D AY P A N D AY NY A 
SEPANJANG	S E2 P A NY J A NG 
SEPATUNYA	S E2 P A T U NY A 
SEPATU	S E2 P A T U 
SEPEDA	S E2 P E D A 
SEPEKAN	S E2 P E2 K A N 
SEPERTINYA	S E2 P E2 R T I NY A 
SEPERTI	S E2 P E2 R T I 
SEPTEMBER	S E P T E M B E2 R 
SEPULUH	S E2 P U L U H 
SEPYATI	S E2 P Y A T I 
SERAGAM	S E2 R A G A M 
SERAHKAN	S E2 R A H K A N 
SERAMBI	S E2 R A M B I 
SERANGAN	S E2 R A NG A N 
SERATUS	S E2 R A T U S 
SERBIA	S E R B I A 
SERBUAN	S E2 R B U A N 
SERFIANUS	S E R F I A N U S 
SERGAH	S E2 R G A H 
SERGAPAN	S E2 R G A P A N 
SERIBU	S E2 R I B U 
SERIKAT	S E2 R I K A T 
SERING	S E2 R I NG 
SERI	S E R I 
SERPIHAN	S E2 R P I H A N 
SERPONG	S E2 R P O NG 
SERSAN	S E R S A N 
SERSE	S E R S E2 
SERTA	S E2 R T A 
SERUPA	S E2 R U P A 
S	E S 
SESEORANG	S E2 S E2 K O R A NG 
SESUAI	S E2 S U AY 
SESUATU	S E2 S U A T U 
SETEBAL	S E2 T E2 B A L 
SETELAH	S E2 T E2 L A H 
SETEMPAT	S E2 T E2 M P A T 
SETENGAH	S E2 T E2 NG A H 
SETERUSNYA	S E2 T E2 R U S NY A 
SETIAP	S E2 T I A P 
SETIBANYA	S E2 T I B A NY A 
SETIDAKNYA	S E2 T I D A NY A 
SETJEN	S E T J E N 
SETNEG	S E T N E G 
SET	S E T 
SETUJU	S E2 T U J U 
SEUKURAN	S E2 K U K U R A N 
SEUSAI	S E2 K U S AY 
SEWAAN	S E W A K A N 
SEWAKTU	S E2 W A K T U 
SEWENANG-WENANG	S E2 W E2 N A NG W E2 N A NG 
SEWU	S E W U 
SEYOGYANYA	S E2 Y O G Y A NY A 
SHAFWAN	S A F W A N 
SHALAT	S O L A T 
SHAMBAZY	S A M B A Z I 
SHANGHAI	S A NG H AY 
SHANTY	S A N T I 
SHEIKH	S E I K 
SHOLAT	S O L A T 
SIANG	S I A NG 
SIAPA	S I A P A 
SIAPKAN	S I A P K A N 
SIAP	S I A P 
SIARAN	S I A R A N 
SIBUK	S I B U K 
SIDANG	S I D A NG 
SIDIK	S I D I K 
SIDNEY	S I D N I 
SIFATNYA	S I F A T NY A 
SIGNIFIKAN	S I G N I F I K A N 
SIHALOHO	S I H A L O H O 
SIH	S I H 
SIKAP	S I K A P 
SILAHKAN	S I L A H K A N 
SILAKAN	S I L A K A N 
SIMATUPANG	S I M A T U P A NG 
SIMBOLIS	S I M B O L I S 
SIMON	S I M O N 
SIMPAN	S I M P A N 
SIM	S I M 
SINAMBELA	S I N A M B E L A 
SINAY	S I N AY 
SINETRON	S I N E T R O N 
SINGAPURA	S I NG A P U R A 
SINGGAH	S I NG G A H 
SINI	S I N I 
SINJAI	S I NY J AY 
SINYO	S I NY O 
SIPADAN	S I P A D A N 
SIRLOIN	S E2 R L OY N 
SISANYA	S I S A NY A 
SI	S I 
SISI	S I S I 
SISTEM	S I S T E2 M 
SISWONO	S I S W O N O 
SISWOYO	S I S W O Y O 
SITI	S I T I 
SITUASI	S I T U A S I 
SITUMORANG	S I T U M O R A NG 
SITU	S I T U 
SITUS	S I T U S 
SITUS-SITUS	S I T U S S I T U S 
SJACHRIEL	SY A KH R I L 
SJAFRIE	SY A F R I 
SJAMSOEDDIN	SY A M S U D I N 
SKEDUL	S K E D U L 
SKENARIONYA	S K E N A R I O NY A 
SKENARIO	S K E N A R I O 
SK	E S K A 
SKI	S K I 
SKOR	S K O R 
SLAMET	S L A M E2 T 
SLEMAN	S L E M A N 
SLIPI	S L I P I 
SLIP	S L I P 
SLTP	E S E L T E P E 
SMA	E S E M A 
SMITH	S M I T 
SMU	E S E M U 
SOALNYA	S O K A L NY A 
SOAL	S O K A L 
SODANYA	S O D A NY A 
SOEBAGYO	S U B A G Y O 
SOEDIBYO	S U D I B Y O 
SOEHARTO	S U H A R T O 
SOEKARNOPUTRI	S U K A R N O P U T R I 
SOERJOGOERITNO	S U R Y O G U R I T N O 
SOETARDJO	S U T A R J O 
SOFYAN	S O F Y A N 
SOGOK-MENYOGOK	S O G O K M E2 NY O G O K 
SOHO	S O H O 
SOLAR	S O L A R 
SOLEKHAH	S O L E KH A H 
SOLIDARITAS	S O L I D A R I T A S 
SOLO	S O L O 
SOLVABILITAS	S O L F A B I L I T A S 
SOMOMOELJONO	S O M O M U L Y O N O 
SONY	S O N I 
SOPIRNYA	S O P I R NY A 
SOPIR	S O P I R 
SORAKAN	S O R A K A N 
SORAK-SORAI	S O R A K S O R AY 
SORE	S O R E 
SOSOK	S O S O K 
SOULISA	S O U L I S A 
SOUL	S O L 
SPANDUK	S P A N D U K 
SPANYOL	S P A NY O L 
SPBU	E S P E B E K U 
SPEKTAKEL	S P E K T A K E2 L 
SPESIALISASINYA	S P E S I A L I S A S I NY A 
SPESIFIK	S P E S I F I K 
SPIRITUAL	S P I R I T U A L 
SPONTAN	S P O N T A N 
SREG	S R E2 G 
SRI	S R I 
SRIWEDARI	S R I W E2 D A R I 
SRIWIJAYA	S R I W I J A Y A 
STABIL	S T A B I L 
STADION	S T A D I O N 
STAFNYA	S T A F NY A 
STAF	S T A F 
STAGNAN	S T A G N A N 
STAMINA	S T A M I N A 
STANDAR	S T A N D A R 
STASIUN	S T A S I U N 
STATUS	S T A T U S 
STEAK	S T EY K 
STIGMA	S T I G M A 
STOP	S T O P 
STRUKTUR	S T R U K T U R 
SUAEB	S U K A E B 
SUAIB	S U K AY B 
SUAMI	S U A M I 
SUARA	S U A R A 
SUASANA	S U A S A N A 
SUATU	S U A T U 
SUBIJAKTO	S U B I Y A K T O 
SUBSTANTIF	S U B S T A N T I F 
SUB	S U B 
SUBVERSI	S U B F E R S I 
SUBYEK	S U B Y E K 
SUBYEKTIVITAS	S U B Y E K T I F I T A S 
SUCAHYO	S U C A H Y O 
SUDAH	S U D A H 
SUDAN	S U D A N 
SUDARSONO	S U D A R S O N O 
SUDARTO	S U D A R T O 
SUDIRMAN	S U D I R M A N 
SUDUT	S U D U T 
SUDWIKATMONO	S U D W I K A T M O N O 
SUFI	S U F I 
SUGITO	S U G I T O 
SUGYATI	S U G Y A T I 
SUHARDI	S U H A R D I 
SUHU	S U H U 
SUJUD	S U J U D 
SUKAI	S U K A I 
SUKARNOPUTRI	S U K A R N O P U T R I 
SUKA	S U K A 
SUKOREJO	S U K O R E2 J O 
SUKSES	S U K S E S 
SULAWESI	S U L A W E2 S I 
SULISTYONO	S U L I S T Y O N O 
SULIT	S U L I T 
SULSEL	S U L S E2 L 
SULTAN	S U L T A N 
SUMADI	S U M A D I 
SUMATERA	S U M A T E2 R A 
SUMBANGAN	S U M B A NG A N 
SUMBER	S U M B E2 R 
SUMSEL	S U M S E2 L 
SUMUR	S U M U R 
SUNAH	S U N A H 
SUNDA	S U N D A 
SUNGAI	S U NG AY 
SUNGGUH	S U NG G U H 
SUNTER	S U N T E2 R 
SUNYI	S U NY I 
SUNYOTO	S U NY O T O 
SUPERMARKET	S U P E2 R M A R K E2 T 
SURABAYA-JAKARTA	S U R A B A Y A J A K A R T A 
SURAIYA	S U R A I Y A 
SURAT	S U R A T 
SURAU-SURAU	S U R AW S U R AW 
SURVEI	S U R F EY 
SURYADHARMA	S U R Y A D A R M A 
SURYO	S U R Y O 
SUSTAINABILITAS	S U S T AY N A B I L I T A S 
SUTANTO	S U T A N T O 
SUTARTO	S U T A R T O 
SUTA	S U T A 
SUTIYOSO	S U T I Y O S O 
SUTOWO	S U T O W O 
SUTRADARA	S U T R A D A R A 
SUWONDO	S U W O N D O 
SUZUKI	S U Z U K I 
SWALAYAN	S W A L A Y A N 
SWASEMBADA	S W A S E2 M B A D A 
SWASTA	S W A S T A 
SWEDIA	S W E D I A 
SWETER	S W E T E R 
SYABIRIN	SY A B I R I N 
SYAEFUL	SY A E F U L 
SYAFEI	SY A F E K I 
SYAFIIE	SY A F I K I 
SYAFII	SY A F I K I 
SYAFIUDDIN	SY A F I U D I N 
SYAFRUDIN	SY A F R U D I N 
SYAHBANDAR	SY A H B A N D A R 
SYAHID	SY A H I D 
SYAHPUTRA	SY A H P U T R A 
SYAHRIL	SY A H R I L 
SYAHRUDIN	SY A H R U D I N 
SYAIFULLAH	SY A I F U L A H 
SYAKIR	SY A K I R 
SYAMSUDDIN	SY A M S U D I N 
SYAMSUDIN	SY A M S U D I N 
SYAMSUL	SY A M S U L 
SYAMSURI	SY A M S U R I 
SYAMTALIRA	SY A M T A L I R A 
SYARAF	SY A R A F 
SYARAT	SY A R A T 
SYARAT-SYARAT	SY A R A T SY A R A T 
SYARIAH	SY A R I K A H 
SYARIAT	SY A R I K A T 
SYARIEF	SY A R I F 
SYARIF	SY A R I F 
SYARIFUDIN	SY A R I F U D I N 
SYAUKANI	SY A U K A N I 
SYED	SY E D 
SYEIS	SY E K I S 
SYEKH	SY E H 
SYIFA	SY I F A 
SYIHAB	SY I H A B 
SYOFIAN	SY O F I A N 
SYUHADA	SY U H A D A 
SYUKRI	SY U K R I 
SYUKURAN	SY U K U R A N 
SYUKUR	SY U K U R 
SYURIAH	SY U R I A H 
SYURO	SY U R O 
SYUTING	SY U T I NG 
TABLOID	T A B L O I D 
TABRAKAN	T A B R A K A N 
TABUNG-TABUNG	T A B U NG T A B U NG 
TABUR	T A B U R 
TABU	T A B U 
TADINYA	T A D I NY A 
TADI	T A D I 
TAGIHAN	T A G I H A N 
TAHANAN	T A H A N A N 
TAHAN	T A H A N 
TAHAPANNYA	T A H A P A N NY A 
TAHAPAN	T A H A P A N 
TAHAP	T A H A P 
TAHUNAN	T A H U N A N 
TAHUN	T A H U N 
TAHU	T A U 
TAJ	T A J 
TAKBIRAN	T A K B I R A N 
TAKLIM	T A K L I M 
TAKRAW	T A K R AW 
TAK	T A K 
TAKTIS	T A K T I S 
TAKUT	T A K U T 
TAMAN	T A M A N 
TAMBAHAN	T A M B A H A N 
TAMBAHNYA	T A M B A H NY A 
TAMBAH	T A M B A H 
TAMBAK	T A M B A K 
TAMBUNAN	T A M B U N A N 
TAMPAK	T A M P A K 
TAMPIL	T A M P I L 
TAMU	T A M U 
TANAH	T A N A H 
TANAKA	T A N A K A
TANAM	T A N A M 
TANDA	T A N D A 
TANDA-TANDA	T A N D A T A N D A 
TANDJUNG	T A N J U NG 
TANGANMU	T A NG A N M U 
TANGANNYA	T A NG A N NY A 
TANGAN	T A NG A N 
TANGERANG	T A NG E2 R A NG 
TANGGAL	T A NG G A L 
TANGGA	T A NG G A 
TANGGUNG	T A NG G U NG 
TANGKAP	T A NG K A P 
TANGKI	T A NG K I 
TANPA	T A N P A 
TANYA	T A NY A 
TAPANULI	T A P A N U L I 
TAPI	T A P I 
TARAF	T A R A F 
TARAKAN	T A R A K A N 
TARAWIH	T A R A W I H 
TARGETKAN	T A R G E T K A N 
TARIF	T A R I F 
TARUHLAH	T A R U H L A H 
TASAWUF	T A S A W U F 
TAS	T A S 
TAS-TAS	T A S T A S 
TASYA	T A SY A 
TATA	T A T A 
TATKALA	T A T K A L A 
TAUFAN	T AW F A N 
TAUFIK	T A U F I K 
TAUFIQ	T AW F I K 
TAULAN	T AW L A N 
TAWARAN	T A W A R A N 
TAWARKAN	T A W A R K A N 
TAWA	T A W A 
TAWAU-NUNUKAN	T A W AW N U N U K A N 
TAWURAN	T A W U R A N 
TAYUB	T A Y U B 
TBC	T E B E S E 
TEATER	T E A T E2 R 
TEBU	T E2 B U 
TEGAK	T E2 G A K 
TEGASNYA	T E2 G A S NY A 
TEGAS	T E2 G A S 
TEH	T E H 
TEKAD	T E K A D 
TEKANAN	T E2 K A N A N 
TEKAN	T E2 K A N 
TEKNIK	T E K N I K 
TEKNISI	T E K N I S I 
TEKNIS	T E K N I S 
TEKO	T E K O 
TEKS	T E K S 
TELAH	T E2 L A H 
TELEKOMUNIKASI	T E L E K O M U N I K A S I 
TELEPON	T E L E P O N 
TELESKOP	T E L E S K O P 
TELEVISI	T E L E F I S I 
TELKOM	T E L K O M 
TELPON	T E L P O N 
TELUNJUK	T E2 L U NY J U K 
TELUR	T E2 L U R 
TEMANNYA	T E2 M A N NY A 
TEMAN	T E2 M A N 
TEMBAKAN	T E M B A K A N 
TEMBOK-TEMBOK	T E M B O K T E M B O K 
TEMPAT	T E2 M P A T 
TEMPO	T E M P O 
TEMPUR	T E2 M P U R 
TENAGA	T E2 N A G A 
TENDER	T E N D E2 R 
TENGAH	T E2 NG A H 
TENGGARA	T E2 NG G A R A 
TENGGAT	T E2 NG G A T 
TENGGELAM	T E2 NG G E2 L A M 
TENGOKLAH	T E NG O K L A H 
TENIS	T E N I S 
TENTANG	T E2 N T A NG 
TENTUNYA	T E2 N T U NY A 
TENTU	T E2 N T U 
TEORETIS	T E O R E T I S 
TEORI	T E O R I 
TEPAT	T E2 P A T 
TEPUKAN	T E2 P U K A N 
TERAKHIR	T E2 R A KH I R 
TERASA	T E2 R A S A 
TERATAI	T E2 R A T AY 
TERBALIK	T E2 R B A L I K 
TERBANG	T E2 R B A NG 
TERBANTU	T E2 R B A N T U 
TERBATAS	T E2 R B A T A S 
TERBENTUK	T E2 R B E2 N T U K 
TERBESAR	T E2 R B E2 S A R 
TERBILANG	T E2 R B I L A NG 
TERBUAT	T E2 R B U A T 
TERBUKA	T E2 R B U K A 
TERCAPAINYA	T E2 R C A P AY NY A 
TERCEMARI	T E2 R C E2 M A R I 
TERCIPTA	T E2 R C I P T A 
TERDAKWA	T E2 R D A K W A 
TERDAPAT	T E2 R D A P A T 
TERDEGRADASI	T E2 R D E G R A D A S I 
TERDEKAT	T E2 R D E2 K A T 
TERDENGAR	T E2 R D E2 NG A R 
TERDIRI	T E2 R D I R I 
TERDISTRIBUSI	T E2 R D I S T R I B U S I 
TERENDAM	T E2 R E2 N D A M 
TERFAVORIT	T E2 R F A F O R I T 
TERGABUNG	T E2 R G A B U NG 
TERGANTUNG	T E2 R G A N T U NG 
TERGESA-GESA	T E2 R G E2 S A G E2 S A 
TERGOLONG	T E2 R G O L O NG 
TERGUGAT	T E2 R G U G A T 
TERGULING	T E2 R G U L I NG 
TERHADANG	T E2 R H A D A NG 
TERHADAP	T E2 R H A D A P 
TERHEGEMONI	T E2 R H E G E M O N I 
TERHENYAK	T E2 R H E2 NY A K 
TERIAKAN	T E2 R I A K A N 
TERIKAT	T E2 R I K A T 
TERIMA	T E2 R I M A 
TERJADI	T E2 R J A D I 
TERJUAL	T E2 R J U A L 
TERKAPAR	T E2 R K A P A R 
TERKECOH	T E2 R K E C O H 
TERKENAL	T E2 R K E2 N A L 
TERKENA	T E2 R K E2 N A 
TERKESAN	T E2 R K E2 S A N 
TERKILIR	T E2 R K I L I R 
TERKOOPTASI	T E2 R K O K O P T A S I 
TERKORUP	T E2 R K O R U P 
TERLALU	T E2 R L A L U 
TERLAMBAT	T E2 R L A M B A T 
TERLAMPAU	T E2 R L A M P AW 
TERLANJUR	T E2 R L A NY J U R 
TERLIBAT	T E2 R L I B A T 
TERLIHAT	T E2 R L I H A T 
TERLUKA	T E2 R L U K A 
TERMASUK	T E2 R M A S U K 
TERORISME	T E R O R I S M E2 
TERORIS	T E R O R I S 
TEROR	T E R O R 
TERPADU	T E2 R P A D U 
TERPAKSA	T E2 R P A K S A 
TERPANCAR	T E2 R P A NY C A R 
TERPANCING	T E2 R P A NY C I NG 
TERPENGARUH	T E2 R P E2 NG A R U H 
TERPIDANA	T E2 R P I D A N A 
TERPILIH	T E2 R P I L I H 
TERPISAH	T E2 R P I S A H 
TERPOLITISASI	T E2 R P O L I T I S A S I 
TERPROVOKASI	T E2 R P R O F O K A S I 
TERSANGKA	T E2 R S A NG K A 
TERSEBUT	T E2 R S E2 B U T 
TERSEDIA	T E2 R S E2 D I A 
TERSEMBUNYI	T E2 R S E2 M B U NY I 
TERSEOK-SEOK	T E2 R S E O K S E O K 
TERSERANG	T E2 R S E2 R A NG 
TERSUSUN	T E2 R S U S U N 
TERTAWA	T E2 R T A W A 
TERTENTU	T E2 R T E2 N T U 
TERTIB	T E2 R T I B 
TERTINGGI	T E2 R T I NG G I 
TERTUTUP	T E2 R T U T U P 
TERUNGKAP	T E2 R U NG K A P 
TERUS-MENERUS	T E2 R U S M E2 N E2 R U S 
TERUS	T E2 R U S 
TERUTAMA	T E2 R U T A M A 
TERWUJUDNYA	T E2 R W U J U D NY A 
TERWUJUD	T E2 R W U J U D 
TES	T E S 
TETAPI	T E2 T A P I 
TETAP	T E2 T A P 
TEVE	T E F E 
TEWASNYA	T E W A S NY A 
TEWAS	T E W A S 
THAHIR	T A H I R 
THALIB	T A L I B 
THEO	T E O 
TIAP	T I A P 
TIBA	T I B A 
TIBA-TIBA	T I B A T I B A 
TIDAK	T I D A K 
TIDURNYA	T I D U R NY A 
TIDUR	T I D U R 
TIGA-EMPAT	T I G A E2 M P A T 
TIGA	T I G A 
TIKETNYA	T I K E T NY A 
TIKET	T I K E T 
TIMBAL	T I M B A L 
TIMBUL	T I M B U L 
TIMNYA	T I M NY A 
TIMOR	T I M O R 
TIMPAL	T I M P A L 
TIM	T I M 
TIMTIM	T I M T I M 
TIMUR	T I M U R 
TINDAKAN	T I N D A K A N 
TINDAK	T I N D A K 
TINGGAL	T I NG G A L 
TINGGINYA	T I NG G I NY A 
TINGGI	T I NG G I 
TINGKAT	T I NG K A T 
TINJAUAN	T I NY J AW A N 
TINJAU	T I NY J AW 
TINJU	T I NY J U 
TINTA	T I N T A 
TIONGHOA	T I O NG H O A 
TIPE	T I P E2 
TIPIS	T I P I S 
TIRAI	T I R AY 
TITIK	T I T I K 
TITIPAN	T I T I P A N 
TIUPAN	T I U P A N 
TJAGER	C A G E2 R 
TJAKRAWERDAJA	C A K R A W E2 R D A Y A 
TKP	T E K A P E 
TNI	T E K E N I 
TOBING	T O B I NG 
TOEDJOE	T U J U 
TOEMION	T U M I O N 
TOGEL	T O G E L 
TOH	T O H 
TOILETNYA	T O I L E T NY A 
TOILET	T O I L E T 
TOKOH	T O K O H 
TOKOH-TOKOH	T O K O H T O K O H 
TOKO	T O K O 
TOKYO	T O K Y O 
TOLAK	T O L A K 
TOLONG	T O L O NG 
TOL	T O L 
TOMAT	T O M A T 
TOMBAK	T O M B A K 
TOMMY	T O M I 
TONGKAT	T O NG K A T 
TOPENG	T O P E NG 
TOPI	T O P I 
TOPOGRAFINYA	T O P O G R A F I NY A 
TOPOGRAFI	T O P O G R A F I 
TOP	T O P 
TOTAL	T O T A L 
TOYOTA	T O Y O T A 
TRADISI	T R A D I S I 
TRAGEDI	T R A G E D I 
TRANSFUSI	T R A N S F U S I 
TRANSIT	T R A N S I T 
TRANSLOKASI	T R A N S L O K A S I 
TRANSMIGRASI	T R A N S M I G R A S I 
TRANSNASIONAL	T R A N S N A S I O N A L 
TRANS	T R A N S 
TRANTIB	T R A N T I B 
TRAUMA	T R AW M A 
TRAVO	T R A F O 
TRIGLISERIDA	T R I G L I S E R I D A 
TRIPLEKS	T R I P L E K S 
TRI	T R I 
TRIWULAN	T R I W U L A N 
TRUK	T R U K 
TUA	T U A 
TUBUHNYA	T U B U H NY A 
TUBUH	T U B U H 
TUDUHAN	T U D U H A N 
TUDUH	T U D U H 
TUGASNYA	T U G A S NY A 
TUGAS	T U G A S 
TUGAS-TUGAS	T U G A S T U G A S 
TUHAN	T U H A N 
TUJUANNYA	T U J U A N NY A 
TUJUAN	T U J U A N 
TUJUH	T U J U H 
TUKARKAN	T U K A R K A N 
TUKAR	T U K A R 
TUMBUH	T U M B U H 
TUMPAH	T U M P A H 
TUNAI	T U N AY 
TUNGAU	T U NG AW 
TUNGGAL	T U NG G A L 
TUNGGU	T U NG G U 
TUNJUKKAN	T U NY J U K K A N 
TUNTASKAN	T U N T A S K A N 
TUNTUTAN	T U N T U T A N 
TUNTUT	T U N T U T 
TUR	T U R 
TURUNNYA	T U R U N NY A 
TURUN	T U R U N 
TUTUP	T U T U P 
TUTURNYA	T U T U R NY A 
TUTUT	T U T U T 
TV	T E F E 
TYASNO	T Y A S N O 
UANGNYA	U A NG NY A 
UANG	U A NG 
UBAH	U B A H 
UBAYA	U B A Y A 
UCAPANNYA	U C A P A N NY A 
UCAPAN-UCAPAN	U C A P A N U C A P A N 
UCAPNYA	U C A P NY A 
UCAP	U C A P 
UCOK	U C O K 
UDANG	U D A NG 
UDARA	U D A R A 
UDIN	U D I N 
UGD	U G E D E 
UGM	U G E K E M 
UI	U K I 
UJANG	U J A NG 
UJARNYA	U J A R NY A 
UJAR	U J A R 
UJIAN	U J I A N 
UJI	U J I 
UJUG-UJUG	U J U G U J U G 
UKHROWI	U KH R O W I 
UKHUWAH	U KH U W A H 
UKULELE	U K U L E L E 
UKURANNYA	U K U R A N NY A 
UKURAN	U K U R A N 
ULAMA	U L A M A 
ULANG	U L A NG 
ULIN	U L I N 
ULTIMATUM	U L T I M A T U M 
UMAR	U M A R 
UMAT	U M A T 
UMUMKAN	U M U M K A N 
UMUM	U M U M 
UNDANGAN	U N D A NG A N 
UNEG-UNEG	U N E2 G U N E2 G 
UNEK-UNEKNYA	U N E2 K U N E2 K NY A 
UNGGUL	U NG G U L 
UNGKAPAN	U NG K A P A N 
UNGKAPNYA	U NG K A P NY A 
UNGKAP	U NG K A P 
UNGU	U NG U 
UNIT	U N I T 
UNIVERSAL	U N I F E2 R S A L 
UNIVERSITAS	U N I F E2 R S I T A S 
UNJUK	U NY J U K 
UNSUR-UNSUR	U N S U R U N S U R 
UNSYIAH	U N SY I A H 
UNTUKMU	U N T U K M U 
UNTUK	U N T U K 
UNTUNG	U N T U NG 
UPACARA	U P A C A R A 
UPAH	U P A H 
UPAYAKAN	U P A Y A K A N 
UPAYA	U P A Y A 
UPAYA-UPAYA	U P A Y A U P A Y A 
URAIAN	U R AY A N 
URAINYA	U R AY NY A 
URAI	U R AY 
UREA	U R E A 
URIP	U R I P 
URUSAN	U R U S A N 
USAHANYA	U S A H A NY A 
USAHA	U S A H A 
USAH	U S A H 
USAI	U S AY 
USANG	U S A NG 
USIR	U S I R 
USTAD	U S T A D 
USULAN	U S U L A N 
USUL	U S U L 
UTAMA	U T A M A 
UTANG	U T A NG 
UTARA	U T A R A 
UTOMO	U T O M O 
UUD	U K U D 
VAKSIN	F A K S I N 
VALUENYA	F E L Y U NY A 
VAN	F A N 
VARIABEL-VARIABEL	F A R I A B E2 L F A R I A B E2 L 
VEGETASI	F E G E2 T A S I 
VENEZUELA	F E N E Z U E L A 
VERBAL	F E2 R B A L 
VERIFIKASI	F E R I F I K A S I 
VERSI	F E R S I 
VERZET	F E R Z E T 
VERZOLA	F E R Z O L A 
VETERAN	F E T E2 R A N 
VIA	F I A 
VIEIRA	F I E I R A 
VIETNAM	F I E T N A M 
VINCENT	F I N S E N 
VIRGINIA	F I R G I N I A 
VISA	F I S A 
VITAL	F I T A L 
VOLUME	F O L U M E2 
VOLUMENYA	F O L U M E2 NY A 
VOLVO	F O L F O 
VONIS	F O N I S 
VOTING	F O T I NG 
VULKANOLOGI	F U L K A N O L O G I 
WABAH	W A B A H 
WACANA	W A C A N A 
WACHID	W A KH I D 
WAGUB	W A G U B 
WAHAI	W A H AY 
WAHID	W A H I D 
WAHYUDI	W A H Y U D I 
WAHYU	W A H Y U 
WAIHAONG	W A I H A O NG 
WAIMURI	W A I M U R I 
WAJAHNYA	W A J A H NY A 
WAJAR	W A J A R 
WAJIB	W A J I B 
WAKABULOG	W A K A B U L O G 
WAKAKORSERSE	W A K A K O R S E R S E 
WAKIL	W A K I L 
WAKTU	W A K T U 
WALAUPUN	W A L AW P U N 
WALAU	W A L AW 
WALHI	W A L H I 
WALIKOTA	W A L I K O T A 
WALISONGO	W A L I S O NG O 
WALI	W A L I 
WALUYO	W A L U Y O 
WANANDI	W A N A N D I 
WANITA	W A N I T A 
WAPRES	W A P R E S 
WARGA	W A R G A 
WARNANYA	W A R N A NY A 
WARNA	W A R N A 
WARTAWAN	W A R T A W A N 
WARTEG	W A R T E2 G 
WARUNG	W A R U NG 
WASIT	W A S I T 
WASPADALAH	W A S P A D A L A H 
WATSON	W A T S O N 
WAYANG	W A Y A NG 
WAYN	W AY N 
WBC	W E B E C E 
WELERI	W E L E R I 
WENAS	W E N A S 
WENDA	W E N D A 
WESEL	W E S E2 L 
WETON	W E2 T O N 
WEWENANGNYA	W E2 W E2 N A NG NY A 
WEWENANG	W E2 W E2 N A NG 
WIBAWA	W I B A W A 
WIBISONO	W I B I S O N O 
WICAKSANA	W I C A K S A N A 
WICAKSONO	W I C A K S O N O 
WIDIGDO	W I D I G D O 
WIDJANARKO	W I J A N A R K O 
WIDJOJANTO	W I J O Y A N T O 
WIDODO	W I D O D O 
WIG	W I G 
WILAYAH	W I L A Y A H 
WILFRED	W I L F R E D 
WILMAR	W I L M A R 
WIMAR	W I M A R 
WINARTA	W I N A R T A 
WIRABHAKTI	W I R A B A K T I 
WIRAHADIKUSUMAH	W I R A H A D I K U S U M A H 
WIRANU	W I R A N U 
WIRASWASTA	W I R A S W A S T A 
WIRID	W I R I D 
WISATAWAN	W I S A T A W A N 
WISKI	W I S K I 
WISNUMURTI	W I S N U M U R T I 
WITOELAR	W I T U L A R 
WIWOHO	W I W O H O 
WIYONO	W I Y O N O 
WNI	W E K E N I 
WOLFENSOHN	W O L F E N S O N 
WONOSOBO	W O N O S O B O 
WOWOR	W O W O R 
WTC	W E T E C E 
WTO	W E T E K O 
WUDU	W U D U 
WUJUDNYA	W U J U D NY A 
WUJUD	W U J U D 
WURYANTO	W U R Y A N T O 
WYNNE	W AY N 
YACOB	Y A K O B 
YAFIE	Y A F I 
YAITU	Y A K I T U 
YAKIN	Y A K I N 
YAKNI	Y A K N I 
YAKOB	Y A K O B 
YANG	Y A NG 
YASIN	Y A S I N 
YA	Y A 
YAYASAN	Y A Y A S A N 
YEL-YEL	Y E L Y E L 
YENI	Y E N I 
YEN	Y E N 
YESUS	Y E S U S 
YLBHI	Y E K E L B E H A K I 
YLKI	Y E K E L K A K I 
YOGYAKARTA	Y O G Y A K A R T A 
YOHANES	Y O H A N E S 
YOPI	Y O P I 
YOSHIDA	Y O SY I D A 
YOS	Y O S 
YOZI	Y O Z I 
YUBERT	Y U B E2 R T 
YUDHOYONO	Y U D O Y O N O 
YUDI	Y U D I 
YUDO	Y U D O 
YUGOSLAVIA	Y U G O S L A F I A 
YULIANA	Y U L I A N A 
YULI	Y U L I 
YUNANI	Y U N A N I 
YUNIOR	Y U N I O R 
YUNI	Y U N I 
YURIDIS	Y U R I D I S 
YUSGIANTORO	Y U S G I A N T O R O 
YUSRIL	Y U S R I L 
YUSUF	Y U S U F 
YUS	Y U S 
YUWONO	Y U W O N O 
YUZRIL	Y U Z R I L 
ZAENAL	Z A E N A L 
ZAGE	Z A G E 
ZAINOEL	Z A I N U L 
ZAINUDDIN	Z A I N U D I N 
ZAKARIA	Z A K A R I A 
ZAKAT	Z A K A T 
ZAKIR	Z A K I R 
ZALDY	Z A L D I 
ZAMAN	Z A M A N 
ZARKASIH	Z A R K A S I H 
ZAT-ZAT	Z A T Z A T 
ZAWAWI	Z A W A W I 
ZEBUA	Z E B U A 
ZEIN	Z E I N 
ZELDY	Z E L D I 
ZEMIN	Z E M I N 
ZENDRATO	Z E N D R A T O 
ZENI	Z E N I 
ZIARAH	Z I A R A H 
ZIA	Z I A 
ZIMBABWE	Z I M B A B W E 
ZIONISME	Z I O N I S M E 
ZIPUR	Z I P U R 
ZOHRA	Z O H R A 
ZONA	Z O N A 
ZONE	Z O N E2 
ZUBAEDAH	Z U B A E D A H 
ZUBAIR	Z U B A I R 
ZUHEIR	Z U H EY R 
ZUIYEN	Z U I Y E N 
ZULFAN	Z U L F A N 
ZULFIKAR	Z U L F I K A R 
ZULKARNAEN	Z U L K A R N A K E N 
ZULKIFLI	Z U L K I F L I 
ZULVAN	Z U L F A N 
